请帮我打开uc	app@launch	o o o o o b-name i-name
打开汽车之家	app@launch	o o b-name i-name i-name i-name
帮我打开人人	app@launch	o o o o b-name i-name
开微信	app@launch	o b-name i-name
给我打开一下qq	app@launch	o o o o o o b-name i-name
帮忙打开一下酷狗音乐播放音乐行不	app@launch	o o o o o o b-name i-name i-name i-name o o o o o o
百度浏览器打开	app@launch	b-name i-name i-name i-name i-name o o
凯立德	app@launch	b-name i-name i-name
打开相机这	app@launch	o o b-name i-name o
打开qq同步助手	app@launch	o o b-name i-name i-name i-name i-name i-name
打开uc二哦	app@launch	o o b-name i-name o o
无锡到阜阳怎么坐汽车？	bus@query	b-src i-src o b-dest i-dest o o o o o o
去深圳怎么坐车？	map@route	o b-endloc_city i-endloc_city o o o o o
南京到，黄山的汽车。	bus@query	b-src i-src o o b-dest i-dest o o o o
在合肥怎么坐去南京的汽车	bus@query	o b-src i-src o o o o b-dest i-dest o o o
可以帮买火车票吗	train@query	o o o o o o o o
我要查找雷迪波尔电影院最新上映的大片	cinemas@query	o o o o b-theatre i-theatre i-theatre i-theatre i-theatre i-theatre i-theatre o o o o o o o
给我放一部最新的电影。	cinemas@query	o o o o o o o o o o o
搜索合肥左岸电影城。	cinemas@query	o o b-theatre i-theatre i-theatre i-theatre i-theatre i-theatre i-theatre o
最近热门的电影。	cinemas@query	o o o o o o o o
现在电影院有什么好电影？	cinemas@query	b-datetime_time i-datetime_time o o o o o o o o o o
哦哦，最新的电影。	cinemas@query	o o o o o o o o o
离我最近的电影院。	cinemas@query	o o o o o o o o o
老马的电话是多少	telephone@query	b-name i-name o o o o o o
张培的电话号码是多少	telephone@query	b-name i-name o o o o o o o o
查看之丽丽的号码	contacts@query	o o b-name i-name i-name o o o
把李会计的电话发给小江	message@sendcontacts	o b-name i-name i-name o o o o o b-receiver i-receiver
把刘荣涛的电话发给王华成	message@sendcontacts	o b-name i-name i-name o o o o o b-receiver i-receiver i-receiver
把孟蕾的电话发给陈姬	message@sendcontacts	o b-name i-name o o o o o b-receiver i-receiver
把高建清的号码发给潘青华	message@sendcontacts	o b-name i-name i-name o o o o o b-receiver i-receiver i-receiver
银耳莲子粥怎么做	cookbook@query	b-dishname i-dishname i-dishname i-dishname i-dishname o o o
蛋黄焗薯条怎么做	cookbook@query	b-dishname i-dishname i-dishname i-dishname i-dishname o o o
扬州炒饭	cookbook@query	b-dishname i-dishname i-dishname i-dishname
糖醋鲤鱼怎么做啊？你只负责吃，c则c。	cookbook@query	b-dishname i-dishname i-dishname i-dishname o o o o o o o o o o o o o o o
萝卜炖排骨汤怎么做？	cookbook@query	b-dishname i-dishname i-dishname i-dishname i-dishname i-dishname o o o o
我说吃飞蟹，怎么做？	cookbook@query	o o o b-ingredient i-ingredient o o o o o
黑芝麻怎么炒？	cookbook@query	b-ingredient i-ingredient i-ingredient o o o o
板栗怎么煮？	cookbook@query	b-ingredient i-ingredient o o o o
鱼香肉丝，怎么炒？	cookbook@query	b-dishname i-dishname i-dishname i-dishname o o o o o
小白菜拌豆腐怎么做呀？	cookbook@query	o b-dishname i-dishname i-dishname i-dishname i-dishname o o o o o
猪肉丸子汤怎么做啊？	cookbook@query	b-dishname i-dishname i-dishname i-dishname i-dishname o o o o o
做苹果麦片粥需要哪写材料？	cookbook@query	o b-dishname i-dishname i-dishname i-dishname i-dishname o o o o o o o
帮我搜索一下红烧排骨。	cookbook@query	o o o o o o b-dishname i-dishname i-dishname i-dishname o
怎么样煮方便面。	cookbook@query	o o o b-dishname i-dishname i-dishname i-dishname o
黑米红豆粥的做法。	cookbook@query	b-dishname i-dishname i-dishname i-dishname i-dishname o o o o
赵柏田鸡怎么做啊？	cookbook@query	o o b-ingredient i-ingredient o o o o o
做黄焖小土豆怎么做啊？	cookbook@query	o o b-dishname i-dishname i-dishname i-dishname o o o o o
帮我找出红烧肉的做法。	cookbook@query	o o o o b-dishname i-dishname i-dishname o o o o
煲鸡汤。	cookbook@query	b-dishname i-dishname i-dishname o
芒果西米露怎么做啊	cookbook@query	b-dishname i-dishname i-dishname i-dishname i-dishname o o o o
胡萝卜怎么炒好吃？	cookbook@query	b-ingredient i-ingredient i-ingredient o o o o o o
红烧肉的做法啊！	cookbook@query	b-dishname i-dishname i-dishname o o o o o
就拉下的饺子怎么做？	cookbook@query	o o o o b-dishname i-dishname o o o o
酸辣藕丁的做法。	cookbook@query	b-dishname i-dishname i-dishname i-dishname o o o o
用电压力锅怎么蒸米粉肉。	cookbook@query	o o b-utensil i-utensil i-utensil o o b-dishname i-dishname i-dishname i-dishname o
请问红烧肉的做法？你，你。	cookbook@query	o o b-dishname i-dishname i-dishname o o o o o o o o
孜然排骨怎么做？	cookbook@query	b-dishname i-dishname i-dishname i-dishname o o o o
肥肠的做法	cookbook@query	b-ingredient i-ingredient o o o
海虾的做法。	cookbook@query	b-ingredient i-ingredient o o o o
脆瓜。	cookbook@query	b-dishname i-dishname o
灌汤小笼包怎样做。	cookbook@query	b-dishname i-dishname i-dishname i-dishname i-dishname o o o o
做红烧肉怎么做？	cookbook@query	o b-dishname i-dishname i-dishname o o o o
打了怎么做红烧肉的做法？	cookbook@query	o o o o o b-dishname i-dishname i-dishname o o o o
蒜茄子怎么做？	cookbook@query	b-dishname i-dishname i-dishname o o o o
木瓜汤怎么做	cookbook@query	b-dishname i-dishname i-dishname o o o
炝拌土豆丝。	cookbook@query	b-dishname i-dishname i-dishname i-dishname i-dishname o
江苏路红薯粉怎么做好吃？	cookbook@query	o o o b-ingredient i-ingredient i-ingredient o o o o o o
姐你红烧肉怎么做呀	cookbook@query	o o b-dishname i-dishname i-dishname o o o o
臭豆腐怎么做啊？	cookbook@query	b-dishname i-dishname i-dishname o o o o o
做红烧肉。	cookbook@query	o b-dishname i-dishname i-dishname o
不懂饭的做法。	cookbook@query	o o b-dishname o o o o
鸡蛋的做法	cookbook@query	b-ingredient i-ingredient o o o
红烧带鱼怎么做？你？	cookbook@query	b-dishname i-dishname i-dishname i-dishname o o o o o o
鱼香肉丝的做法啊！	cookbook@query	b-dishname i-dishname i-dishname i-dishname o o o o o
周黑鸭怎么做？	cookbook@query	o o b-ingredient o o o o
那好，那你告诉我西红柿炒鸡蛋，怎么去做？	cookbook@query	o o o o o o o o b-dishname i-dishname i-dishname i-dishname i-dishname i-dishname o o o o o o
干贝怎么做？	cookbook@query	b-ingredient i-ingredient o o o o
怎么做？酸菜鱼？	cookbook@query	o o o o b-dishname i-dishname i-dishname o
鸡爪怎么炒？	cookbook@query	b-ingredient i-ingredient o o o o
干锅鱼怎么做	cookbook@query	b-dishname i-dishname i-dishname o o o
糖醋排骨怎么做？好了额，你。	cookbook@query	b-dishname i-dishname i-dishname i-dishname o o o o o o o o o o
清蒸鱼怎么做？吴？	cookbook@query	b-dishname i-dishname i-dishname o o o o o o
刘林面怎么做啊？	cookbook@query	o o b-ingredient o o o o o
酸菜粉条肉的做法。	cookbook@query	b-dishname i-dishname i-dishname i-dishname b-ingredient o o o o
讯飞语点请你搜索一下番茄炒蛋怎么做？	cookbook@query	o o o o o o o o o o b-dishname i-dishname i-dishname i-dishname o o o o
红烧肉怎么煮啊	cookbook@query	b-dishname i-dishname i-dishname o o o o
面包怎么做	cookbook@query	b-dishname i-dishname o o o
请问鱼块的做法。	cookbook@query	o o b-ingredient i-ingredient o o o o
猪大肠怎么炒？	cookbook@query	b-ingredient i-ingredient i-ingredient o o o o
小猪哨糖醋排骨的做法。	cookbook@query	o o o b-dishname i-dishname i-dishname i-dishname o o o o
嗯咯鸡爪怎么做的。	cookbook@query	o o b-ingredient i-ingredient o o o o o
鲤鱼怎么做？	cookbook@query	b-ingredient i-ingredient o o o o
炸里鸡的做法。	cookbook@query	b-dishname i-dishname i-dishname o o o o
不，做个红烧肉怎么做？	cookbook@query	o o o o b-dishname i-dishname i-dishname o o o o
拔丝芋头怎么做	cookbook@query	b-dishname i-dishname i-dishname i-dishname o o o
帮我发邮件给婷婷	email@send	o o o o o o b-name i-name
替我回复这封邮件	email@reply	o o o o o o o o
我要回复这个邮件	email@reply	o o o o o o o o
发邮件给灿灿说明早我们一起跑步	email@send	o o o o b-name i-name o b-content i-content i-content i-content i-content i-content i-content i-content
给我看新邮件	email@launch	o o o o o o
我想要全部答复	email@replay_all	o o o o o o o
今天晚上有没有中国好声音呢？	epg@query	b-datetime_date i-datetime_date b-datetime_time i-datetime_time o o o b-name i-name i-name i-name i-name o o
你知道现在广东卫视在演什么吗？	epg@query	o o o b-datetime_time i-datetime_time b-tvchannel i-tvchannel i-tvchannel i-tvchannel o o o o o o
今晚看什么电影？	epg@query	b-datetime_time i-datetime_time o o o b-category i-category o
金鹰卡通今天晚上放什么节目？	epg@query	b-tvchannel i-tvchannel i-tvchannel i-tvchannel b-datetime_date i-datetime_date b-datetime_time i-datetime_time o o o o o o
15号的我愿意	epg@query	b-datetime_date i-datetime_date i-datetime_date o b-name i-name i-name
北京青年频道谁在说	epg@query	b-tvchannel i-tvchannel i-tvchannel i-tvchannel i-tvchannel i-tvchannel b-name i-name i-name
看一下今天晚上广西台有没有警戒线？	epg@query	o o o b-datetime_date i-datetime_date b-datetime_time i-datetime_time b-tvchannel i-tvchannel i-tvchannel o o o b-name i-name i-name o
广西电视台现在播放什么节目？	epg@query	b-tvchannel i-tvchannel i-tvchannel i-tvchannel i-tvchannel b-datetime_time i-datetime_time o o o o o o o
cctv9明晚有转播仁心解码2呢	epg@query	b-tvchannel i-tvchannel i-tvchannel i-tvchannel i-tvchannel b-datetime_time i-datetime_time o o o b-name i-name i-name i-name i-name o
搜一下今天中午开始放郭的秀	epg@query	o o o b-datetime_date i-datetime_date b-datetime_time i-datetime_time o o o b-name i-name i-name
读书频道上个星期五有播放新闻联播吗	epg@query	b-tvchannel i-tvchannel i-tvchannel i-tvchannel b-datetime_date i-datetime_date i-datetime_date i-datetime_date i-datetime_date o o o b-name i-name i-name i-name o
湖南卫视有什么节目	epg@query	b-tvchannel i-tvchannel i-tvchannel i-tvchannel o o o o o
明晚真人秀频道有播放过百变大咖秀呢	epg@query	b-datetime_time i-datetime_time b-tvchannel i-tvchannel i-tvchannel i-tvchannel i-tvchannel o o o o b-name i-name i-name i-name i-name o
湖北卫视今天下午六点以后开始播男生女生向前冲	epg@query	b-tvchannel i-tvchannel i-tvchannel i-tvchannel b-datetime_date i-datetime_date b-datetime_time i-datetime_time i-datetime_time i-datetime_time i-datetime_time i-datetime_time o o o b-name i-name i-name i-name i-name i-name i-name
帮我查查北京电视台-6上周六开始美味的想念呢	epg@query	o o o o b-tvchannel i-tvchannel i-tvchannel i-tvchannel i-tvchannel i-tvchannel i-tvchannel b-datetime_date i-datetime_date i-datetime_date o o b-name i-name i-name i-name i-name o
中央六台的节目单	epg@query	b-tvchannel i-tvchannel i-tvchannel i-tvchannel o o o o
回放昨晚的焦点访谈	epg@look_back	o o b-datetime_time i-datetime_time o b-name i-name i-name i-name
明天安徽卫视演什么	epg@query	b-datetime_date i-datetime_date b-tvchannel i-tvchannel i-tvchannel i-tvchannel o o o
江西卫视三天之后放一站到底么	epg@query	b-tvchannel i-tvchannel i-tvchannel i-tvchannel b-datetime_date i-datetime_date i-datetime_date i-datetime_date o b-name i-name i-name i-name o
贵州卫视今晚看什么电视剧？	epg@query	b-tvchannel i-tvchannel i-tvchannel i-tvchannel b-datetime_time i-datetime_time o o o b-category i-category i-category o
湖南卫视现在演什么节目	epg@query	b-tvchannel i-tvchannel i-tvchannel i-tvchannel b-datetime_time i-datetime_time o o o o o
东营到济南的航班	flight@query	b-startloc_city i-startloc_city o b-endloc_city i-endloc_city o o o
十月四号从广州到北京的飞机票多少钱	flight@query	b-startdate_date i-startdate_date i-startdate_date i-startdate_date o b-startloc_city i-startloc_city o b-endloc_city i-endloc_city o o o o o o o
查询上海到丽江飞机票的价格	flight@query	o o b-startloc_city i-startloc_city o b-endloc_city i-endloc_city o o o o o o
明天从桂林到杭州的航班	flight@query	b-startdate_date i-startdate_date o b-startloc_city i-startloc_city o b-endloc_city i-endloc_city o o o
武汉到北京的飞机票	flight@query	b-startloc_city i-startloc_city o b-endloc_city i-endloc_city o o o o
有没有下周二到贵阳的航班	flight@query	o o o b-startdate_date i-startdate_date i-startdate_date o b-endloc_city i-endloc_city o o o
明天去徐州的航班	flight@query	b-startdate_date i-startdate_date o b-endloc_city i-endloc_city o o o
查询今天上海到成都的航班	flight@query	o o b-startdate_date i-startdate_date b-startloc_city i-startloc_city o b-endloc_city i-endloc_city o o o
查下上海到太原的机票	flight@query	o o b-startloc_city i-startloc_city o b-endloc_city i-endloc_city o o o
上海到北京的飞机航班	flight@query	b-startloc_city i-startloc_city o b-endloc_city i-endloc_city o o o o o
机票	flight@query	o o
去桂林的航班怎样	flight@query	o b-endloc_city i-endloc_city o o o o o
阜阳到温州的航班	flight@query	b-startloc_city i-startloc_city o b-endloc_city i-endloc_city o o o
帮我查一下从济南到福州的机票	flight@query	o o o o o o b-startloc_city i-startloc_city o b-endloc_city i-endloc_city o o o
更年期综合症。	health@query	b-keyword i-keyword i-keyword i-keyword i-keyword i-keyword o
肠胃炎怎么治？	health@query	b-keyword i-keyword i-keyword o o o o
得了关节炎怎么办？	health@query	o o b-keyword i-keyword i-keyword o o o o
得了皮肤病怎么办？	health@query	o o b-keyword i-keyword i-keyword o o o o
甲亢怎么治疗？	health@query	b-keyword i-keyword o o o o o
多囊肾怎么治啊？	health@query	b-keyword i-keyword i-keyword o o o o o
包皮包茎	health@query	b-keyword i-keyword i-keyword i-keyword
黄疸	health@query	b-keyword i-keyword
暴发性紫癜	health@query	b-keyword i-keyword i-keyword i-keyword i-keyword
肺结核要注意些啥	health@query	b-keyword i-keyword i-keyword o o o o o
痛经。	health@query	b-keyword i-keyword o
如何治疗脚气	health@query	o o o o b-keyword i-keyword
破伤风该怎么处理	health@query	b-keyword i-keyword i-keyword o o o o o
帮我查一下2013年2月8日开奖的七星彩中奖号码	lottery@number_query	o o o o o b-datetime_date i-datetime_date i-datetime_date i-datetime_date i-datetime_date i-datetime_date i-datetime_date i-datetime_date i-datetime_date o o o b-name i-name i-name o o o o
看一看七乐彩的信息	lottery@number_query	o o o b-name i-name i-name o o o
搜索25选5的获奖号码	lottery@number_query	o o b-name i-name i-name i-name o o o o o
河北在哪里	map@position	b-location_province i-location_province o o o
从济源市到河南省电信分公司怎么走	map@route	o b-startloc_city i-startloc_city i-startloc_city o b-endloc_province i-endloc_province i-endloc_province b-endloc_poi i-endloc_poi i-endloc_poi i-endloc_poi i-endloc_poi o o o
龙口西路在哪里	map@position	b-location_poi i-location_poi i-location_poi i-location_poi o o o
去金湖县城	map@route	o b-endloc_poi i-endloc_poi i-endloc_poi i-endloc_poi
上海到北京怎么走	map@route	b-startloc_city i-startloc_city o b-endloc_city i-endloc_city o o o
玉照公园怎么走	map@route	b-endloc_poi i-endloc_poi i-endloc_poi i-endloc_poi o o o
怎么去农业银行	map@route	o o o b-endloc_poi i-endloc_poi i-endloc_poi i-endloc_poi
南山医院到北大医院路线	map@route	b-startloc_poi i-startloc_poi i-startloc_poi i-startloc_poi o b-endloc_poi i-endloc_poi i-endloc_poi i-endloc_poi o o
从武汉到呼和浩特	map@route	o b-startloc_city i-startloc_city o b-endloc_city i-endloc_city i-endloc_city i-endloc_city
帮我看一下到科大讯飞最快的是哪条路线	map@route	o o o o o o b-endloc_poi i-endloc_poi i-endloc_poi i-endloc_poi o o o o o o o o
杭州到上海	map@route	b-startloc_city i-startloc_city o b-endloc_city i-endloc_city
查查科大讯飞在哪儿	map@position	o o b-location_poi i-location_poi i-location_poi i-location_poi o o o
查查科大讯飞在哪里	map@position	o o b-location_poi i-location_poi i-location_poi i-location_poi o o o
新东站怎么走	map@route	b-endloc_poi i-endloc_poi i-endloc_poi o o o
去红心中路怎么走	map@route	o b-endloc_poi i-endloc_poi i-endloc_poi i-endloc_poi o o o
去华强北的路怎么走	map@route	o b-endloc_poi i-endloc_poi i-endloc_poi o o o o o
广州恒大比赛谁赢了。	match@query	b-name i-name i-name i-name o o o o o o
中超赛事预告，你。	match@query	b-category i-category o o b-type i-type o o o
宏大俱乐部赛程。	match@query	b-name i-name o o o o o o
武汉卓尔的赛程。	match@query	b-name i-name i-name i-name o o o o
广州恒大比赛比分。	match@query	b-name i-name i-name i-name b-type i-type o o o
发短信给王二白叫她明天过来玩	message@send	o o o o b-name i-name i-name o o b-content i-content i-content i-content i-content
发消息给周磊	message@send	o o o o b-name i-name
发短信方钰玲	message@send	o o o b-name i-name i-name
写短信给颖村	message@send	o o o o b-name i-name
给杨凯发短信	message@send	o b-name i-name o o o
给李慧发个短信说我要回家	message@send	o b-name i-name o o o o o b-content i-content i-content i-content
发送短信给老婆我在三号楼三零幺刚才那个教室关门了	message@send	o o o o o b-name i-name b-content i-content i-content i-content i-content i-content i-content i-content i-content i-content i-content i-content i-content i-content i-content i-content i-content
给孟南发短信	message@send	o b-name i-name o o o
发条短信给杨桑	message@send	o o o o o b-name i-name
发短信给王曼希望你幸福	message@send	o o o o b-name i-name o o o o o
发短信给林晓云说我爱你	message@send	o o o o b-name i-name i-name o b-content i-content i-content
传简讯给家里	message@send	o o o o b-name i-name
发信息给瀌瀌	message@send	o o o o b-name i-name
我要发信息给高鹤航	message@send	o o o o o o b-name i-name i-name
给查乐发短信	message@send	o b-name i-name o o o
给栾佳佳发短信说回到济南了	message@send	o b-name i-name i-name o o o o b-content i-content i-content i-content i-content
点一首爱情买卖来听听	music@play	o o o b-song i-song i-song i-song o o o
播放音乐喜帖街。	music@play	o o o o b-song i-song i-song o
随便唱首歌。	music@play	o o o o o o
给我来一首，相见恨晚的音乐。	music@play	o o o o o o b-song i-song i-song i-song o o o o
she的歌	music@play	b-artist i-artist i-artist o o
我想听期待这首歌	music@play	o o o b-song i-song o o o
来一首隐形的翅膀。	music@play	o o o b-song i-song i-song i-song i-song o
来一首不可以。	music@play	o o o b-song i-song i-song o
哦来一首忘情水	music@play	o o o o b-song i-song i-song
歌曲白天不懂夜的黑	music@play	o o b-song i-song i-song i-song i-song i-song i-song
我想听星月神话	music@play	o o o b-song i-song i-song i-song
来一首有点舍不得	music@play	o o o b-song i-song i-song i-song i-song
播放音乐月亮之上的。	music@play	o o o o b-song i-song i-song i-song o o
我要听张雨生的歌。	music@play	o o o b-artist i-artist i-artist o o o
来点歌听听	music@play	o o o o o
来一首我们的歌谣。	music@play	o o o b-song i-song i-song i-song i-song o
给我放一首最炫民族风。	music@play	o o o o o b-song i-song i-song i-song i-song o
放一首青花瓷哦哦	music@play	o o o b-song i-song i-song o o
毛阿敏的歌	music@play	b-artist i-artist i-artist o o
来首出师表	music@play	o o b-song i-song i-song
啊，社会新闻。	news@play	o o b-category i-category o o o
泰州新闻。	news@play	b-location_city i-location_city o o o
今日头条新闻。	news@play	b-media i-media i-media i-media o o o
k新闻想听新闻。	news@play	o o o o o o o o
t我要听新闻。	news@play	o o o o o o o
盘锦新闻。	news@play	b-location_city i-location_city o o o
现在有什么热点新闻？	news@play	b-datetime_time i-datetime_time o o o b-category i-category o o o
关注一下今天的欧洲杯新闻	news@play	o o o o b-datetime_date i-datetime_date o b-keyword i-keyword i-keyword o o
该我读新闻。	news@play	o o o o o o
占田你给我放一下最近的新闻。	news@play	o o o o o o o o b-datetime_date i-datetime_date o o o o
帮我查一查今天的新闻。	news@play	o o o o o b-datetime_date i-datetime_date o o o o
么，哥来一下最新的新闻。	news@play	o o o o o o o o o o o o
我想知道今天的娱乐新闻。	news@play	o o o o b-datetime_date i-datetime_date o b-category i-category o o o
有什么好看的校园小说	novel@query	o o o b-popularity i-popularity o b-category i-category o o
搜一搜三毛的小说	novel@query	o o o b-author i-author o o o
我要看唯美童话小说	novel@query	o o o b-category i-category i-category i-category o o
我要看末世进化小说	novel@query	o o o b-category i-category i-category i-category o o
搜索极品天王	novel@query	o o b-name i-name i-name i-name
找找三毛的爱情小说	novel@query	o o b-author i-author o b-category i-category o o
我想看现在很流行的小说	novel@query	o o o o o o b-popularity i-popularity o o o
我要看图文小说	novel@query	o o o b-category i-category o o
你背首唐诗给我听听啊	poetry@query	o o o b-dynasty o o o o o o
来一首白居易的诗	poetry@query	o o o b-author i-author i-author o o
唐代诗人李白。	poetry@query	b-dynasty o o o b-author i-author o
搜索一下白居易的诗。	poetry@query	o o o o b-author i-author i-author o o o
火气冲天，下一句是什么？	poetry@query	b-keyword i-keyword i-keyword i-keyword o b-queryfield i-queryfield i-queryfield o o o o
念首唐诗吧！	poetry@query	o o b-dynasty o o o
给我背一首诗。	poetry@default	o o o o o o o
朗读一首李白的诗呗！	poetry@query	o o o o b-author i-author o o o o
背首宋词。	poetry@query	o o b-dynasty o o
呦呦鹿鸣的下一句。	poetry@query	b-keyword i-keyword i-keyword i-keyword o b-queryfield i-queryfield i-queryfield o
那给我背静夜思。	poetry@query	o o o o b-name i-name i-name o
朗读岳飞的满江红。	poetry@query	o o b-author i-author o b-name i-name i-name o
天王盖地虎的下一句是什么？	poetry@query	b-keyword i-keyword i-keyword i-keyword i-keyword o b-queryfield i-queryfield i-queryfield o o o o
唐诗哦。	poetry@query	b-dynasty o o o
说个李白的诗来听听。	poetry@query	o o b-author i-author o o o o o o
造化钟神秀的下一句是什么？	poetry@query	b-keyword i-keyword i-keyword i-keyword i-keyword o b-queryfield i-queryfield i-queryfield o o o o
读首唐诗来听听。	poetry@query	o o b-dynasty o o o o o
来一首琵琶行。	poetry@query	o o o b-name i-name i-name o
背一首李白的诗来听听。	poetry@query	o o o b-author i-author o o o o o o
搜索岳飞的诗满江红。	poetry@query	o o b-author i-author o o b-name i-name i-name o
背诵唐诗三百首静夜思。	poetry@query	o o b-dynasty o o o o b-name i-name i-name o
来首纳兰性德的词。	poetry@query	o o b-author i-author i-author i-author o o o
背一首声声慢。	poetry@query	o o o b-name i-name i-name o
若相惜不弃下一句是什么？	poetry@query	b-keyword i-keyword i-keyword i-keyword i-keyword b-queryfield i-queryfield i-queryfield o o o o
背首杜甫的诗啊？	poetry@query	o o b-author i-author o o o o
读首唐诗	poetry@query	o o b-dynasty o
我背一首生查子。	poetry@query	o o o o b-name i-name i-name o
我给我念一首李白的诗吧？	poetry@query	o o o o o o b-author i-author o o o o
打开安徽交通台	radio@launch	o o b-name i-name i-name i-name i-name
帮忙讲几个谜语给我猜。	riddle@query	o o o o o b-category i-category o o o o
说个谜语给我猜猜。	riddle@query	o o b-category i-category o o o o o
帮我出一个灯谜。	riddle@query	o o o o o b-category i-category o
出一个谜语给我猜猜吧！	riddle@query	o o o b-category i-category o o o o o o
你说谜语给我猜。	riddle@query	o o b-category i-category o o o o
给我打个谜语，啊！	riddle@query	o o o o b-category i-category o o o
再讲一个谜语吧！	riddle@query	o o o o b-category i-category o o
讲个谜语吧，辣。	riddle@query	o o b-category i-category o o o o
不辣，猜谜语。	riddle@query	o o o o b-category i-category o
动物谜语。	riddle@query	b-category i-category i-category i-category o
南京熊猫股票	stock@query	b-name i-name i-name i-name o o
泰山石油股票	stock@query	b-name i-name i-name i-name o o
科大讯飞的股价如何	stock@query	b-name i-name i-name i-name o o o o o
我想了解地产板块股票现在怎么样	stock@query	o o o o b-name i-name i-name i-name o o o o o o o
罗顿发展的股票	stock@query	b-name i-name i-name i-name o o o
查寻轻舞风股票	stock@query	o o b-name i-name i-name o o
科大讯飞的股票是多少a	stock@query	b-name i-name i-name i-name o o o o o o o
查询标准股份的股票	stock@query	o o b-name i-name i-name i-name o o o
查询一下南方航空的股票	stock@query	o o o o b-name i-name i-name i-name o o o
查询股票00230	stock@query	o o o o b-code i-code i-code i-code i-code
查询中国石化的股价	stock@query	o o b-name i-name i-name i-name o o o
保利地产的股票	stock@query	b-name i-name i-name i-name o o o
中国建设银行的行情	stock@query	o o b-name i-name i-name i-name o o o
查寻三星股价	stock@query	o o b-name i-name o o
今天上证指数是几点	stock@query	o o b-name i-name i-name i-name o o o
查找科大讯飞股票的股价	stock@query	o o b-name i-name i-name i-name o o o o o
我要打电话给洪云刚	telephone@dial	o o o o o o b-name i-name i-name
打电话给张帕楼	telephone@dial	o o o o b-name i-name i-name
打电话给阿华	telephone@dial	o o o o b-name i-name
打给宋成钢	telephone@dial	o o b-name i-name i-name
请打电话给沈晨浩	telephone@dial	o o o o o b-name i-name i-name
给叶君恩打电话	telephone@dial	o b-name i-name i-name o o o
给爸爸打电话	telephone@dial	o b-name i-name o o o
打电话温正军	telephone@dial	o o o b-name i-name i-name
给曹广义打电话	telephone@dial	o b-name i-name i-name o o o
打电话给hello word	telephone@dial	o o o o b-name i-name i-name i-name i-name i-name i-name i-name i-name i-name
查寻上海到北京的火车票	train@query	o o b-startloc_city i-startloc_city o b-endloc_city i-endloc_city o o o o
从广州到南昌的火车票时刻表	train@query	o b-startloc_city i-startloc_city o b-endloc_city i-endloc_city o o o o o o o
查一下从杭州到上海高铁时刻表	train@query	o o o o b-startloc_city i-startloc_city o b-endloc_city i-endloc_city b-category i-category o o o
查一下从广州到南宁的火车票	train@query	o o o o b-startloc_city i-startloc_city o b-endloc_city i-endloc_city o o o o
查询临沂到济南的火车票	train@query	o o b-startloc_city i-startloc_city o b-endloc_city i-endloc_city o o o o
连云港到徐州的火车票	train@query	b-startloc_city i-startloc_city i-startloc_city o b-endloc_city i-endloc_city o o o o
帮我查下上海到合肥的火车	train@query	o o o o b-startloc_city i-startloc_city o b-endloc_city i-endloc_city o o o
帮我查一下宁波到郑州的火车	train@query	o o o o o b-startloc_city i-startloc_city o b-endloc_city i-endloc_city o o o
星期四去上海的火车	train@query	b-startdate_date i-startdate_date i-startdate_date o b-endloc_city i-endloc_city o o o
从余姚到贵阳的火车票	train@query	o b-startloc_area i-startloc_area o b-endloc_city i-endloc_city o o o o
北京到上海的火车票	train@query	b-startloc_city i-startloc_city o b-endloc_city i-endloc_city o o o o
查询湛江到广州的火车票	train@query	o o b-startloc_city i-startloc_city o b-endloc_city i-endloc_city o o o o
查一下明天下午南通到南京的火车票	train@query	o o b-startdate_time i-startdate_time i-startdate_date o o b-startloc_city i-startloc_city o o o o o o o
帮我查一下从开封到郑州的火车几点发	train@query	o o o o o o b-startloc_city i-startloc_city o b-endloc_city i-endloc_city o o o o o o
查询广州到贵港的火车	train@query	o o b-startloc_city i-startloc_city o b-endloc_city i-endloc_city o o o
去南昌的火车	train@query	o b-endloc_city i-endloc_city o o o
杭州到北京的火车班次	train@query	b-startloc_city i-startloc_city o b-endloc_city i-endloc_city o o o o o
明天广州到长葛的火车	train@query	b-startdate_date i-startdate_date b-startloc_city i-startloc_city o b-endloc_area i-endloc_area o o o
今天我要去逛街用英语说	translation@translation	b-content i-content i-content i-content i-content i-content i-content o b-target i-target o
翻译光大银行	translation@translation	o o b-content i-content i-content i-content
翻译芬兰	translation@translation	o o b-content i-content
出口在哪里英文怎么说	translation@translation	b-content i-content i-content i-content i-content b-target i-target o o o
虾的英文怎么说	translation@translation	b-content o b-target i-target o o o
挑逗你真好玩儿英语怎么说	translation@translation	b-content i-content i-content i-content i-content i-content i-content b-target i-target o o o
你还没有结婚用英语怎么讲	translation@translation	b-content i-content i-content i-content i-content i-content o b-target i-target o o o
苹果翻译成英语	translation@translation	b-content i-content o o o b-target i-target
你吃过早饭了吗用英文怎么讲	translation@translation	b-content i-content i-content i-content i-content i-content i-content o b-target i-target o o o
我记住了用英文怎么讲	translation@translation	b-content i-content i-content i-content o b-target i-target o o o
翻译秋天	translation@translation	o o b-content i-content
翻译背首诗	translation@translation	o o b-content i-content i-content
汽车英语怎么讲	translation@translation	b-content i-content b-target i-target o o o
早上好英语怎么讲	translation@translation	b-content i-content i-content b-target i-target o o o
高清中央8	tvchannel@play	b-resolution i-resolution b-name i-name i-name
央视9	tvchannel@play	b-name i-name i-name
cctv农业	tvchannel@play	b-name i-name i-name i-name i-name i-name
打开浦口生活资讯频道	tvchannel@play	o o b-name i-name i-name i-name i-name i-name o o
北京二	tvchannel@play	b-name i-name i-name
卡酷少儿频道	tvchannel@play	b-name i-name i-name i-name i-name i-name
我要看云南二台	tvchannel@play	o o o b-name i-name i-name i-name
cctv-12套的节目单	epg@query	b-tvchannel i-tvchannel i-tvchannel i-tvchannel i-tvchannel i-tvchannel i-tvchannel o o o o o
找深圳卫视	tvchannel@play	o b-name i-name i-name i-name
我想看中央十三频道	tvchannel@play	o o o b-name i-name i-name i-name i-name i-name
高清中央电视台电影频道	tvchannel@play	b-resolution i-resolution b-name i-name i-name i-name i-name i-name i-name i-name i-name
山东高清	tvchannel@play	b-name i-name i-name i-name
湖北电视台	tvchannel@play	b-name i-name i-name i-name i-name
北京二台高清	tvchannel@play	b-name i-name i-name i-name b-resolution i-resolution
跳换到湖南卫视	tvchannel@play	o o o b-name i-name i-name i-name
山东台高清	tvchannel@play	b-name i-name i-name b-resolution i-resolution
cctv新闻	tvchannel@play	b-name i-name i-name i-name i-name i-name
新闻解码	tvchannel@play	b-name i-name i-name i-name
江苏党校二套	tvchannel@play	b-name i-name i-name i-name i-name i-name
播放2005年励志动漫	video@query	o o b-datetime_date i-datetime_date i-datetime_date i-datetime_date i-datetime_date b-tag i-tag b-category i-category
请搜电影画皮	video@query	o o b-category i-category b-name i-name
张艺谋的甄嬛传	video@query	b-artist i-artist i-artist o b-name i-name i-name
小c我想看北京青年	video@query	o o o o o b-name i-name i-name i-name
要看特种兵	video@query	o o b-name i-name i-name
青春四十	video@query	b-name i-name i-name i-name
电影十二生肖	video@query	b-category i-category b-name i-name i-name i-name
整人专家的电影	video@query	b-name i-name i-name i-name o b-category i-category
汽车总动员	video@query	b-name i-name i-name i-name i-name
第二梦	video@query	b-name i-name i-name
蝎子王蝎子王	video@query	b-name i-name i-name o o o
找一下非诚勿扰娱乐节目	video@query	o o o b-name i-name i-name i-name b-tag i-tag b-category i-category
我要看功夫熊猫帮我播放出来	video@query	o o o b-name i-name i-name i-name o o o o o o
查雷神电影	video@query	o b-name i-name b-category i-category
青瓷电视剧	video@query	b-name i-name b-category i-category i-category
请帮我打开电影	video@query	o o o o o b-category i-category
小c帮我搜一下断剑视频	video@query	o o o o o o o b-name i-name o o
我要看西游记啊	video@query	o o o b-name i-name i-name o
夜访吸血鬼	video@query	b-name i-name i-name i-name i-name
憨豆特工	video@query	b-name i-name i-name i-name
文艺片	video@query	b-tag i-tag b-category
体育赛事直播	tvchannel@play	b-name i-name i-name i-name o o
美国电影破碎之城	video@query	b-area i-area b-category i-category b-name i-name i-name i-name
大耳朵图图获	video@query	b-name i-name i-name i-name i-name o
搜幕府风云	video@query	o b-name i-name i-name i-name
三女休夫	video@query	b-name i-name i-name i-name
惊情四百年	video@query	b-name i-name i-name i-name i-name
魔幻电影	video@query	b-tag i-tag b-category i-category
我想看爱在春天	video@query	o o o b-name i-name i-name i-name
金枝欲孽	video@query	b-name i-name i-name i-name
爱情工寓	video@query	b-name i-name i-name i-name
我想看电影台北飘雪	video@query	o o o b-category i-category b-name i-name i-name i-name
现在温度几度	weather@query	o o o o o o
打开浦发银行	website@open	o o b-name i-name i-name i-name
打开聚划算网站	website@open	o o b-name i-name i-name o o
打开网页猫扑	website@open	o o o o b-name i-name
那你帮我打开百度	website@open	o o o o o o b-name i-name
打开腾讯拍拍网	website@open	o o b-name i-name i-name i-name i-name
访问京东商城的网页	website@open	o o b-name i-name o o o o o
打开江苏移动网上营业厅网页	website@open	o o b-name i-name i-name i-name i-name o o o o o o
易车网看看	website@open	b-name i-name i-name o o
帮我上下新浪网	website@open	o o o o b-name i-name i-name
帮我链接到新浪网	website@open	o o o o o b-name i-name i-name
打开猫扑	website@open	o o b-name i-name
开网页	website@open	o o o
打开新浪网我肏	website@open	o o b-name i-name i-name o o
打开我的浏览器	app@launch	o o o o b-name i-name i-name
打开qq浏览器	app@launch	o o b-name i-name i-name i-name i-name
打开音乐播放器	app@launch	o o b-name i-name i-name i-name i-name
启动浏览器	app@launch	o o b-name i-name i-name
帮我搜索三国杀	app@query	o o o o b-name i-name i-name
打开极品飞车	app@launch	o o b-name i-name i-name i-name
公交查询	app@launch	b-name i-name i-name i-name
打开搜狐新闻	app@launch	o o b-name i-name i-name i-name
图库	app@launch	b-name i-name
camera360	app@launch	b-name i-name i-name i-name i-name i-name i-name i-name i-name
进入手机qq	app@launch	o o o o b-name i-name
打开优酷视频	app@launch	o o b-name i-name i-name i-name
从北海到东莞的汽车。	bus@query	o b-src i-src o b-dest i-dest o o o o
从汕头到西安的汽车。	bus@query	o b-src i-src o b-dest i-dest o o o o
从东莞去北海的汽车。	bus@query	o b-src i-src o b-dest i-dest o o o o
从南昌到长沙的汽车。	bus@query	o b-src i-src o b-dest i-dest o o o o
帮我查一下温州到汉中的汽车。	bus@query	o o o o o b-src i-src o b-dest i-dest o o o o
去肇庆市怎么坐车？	map@route	o b-endloc_city i-endloc_city o o o o o o
查询福建电影院的热映电影	cinemas@query	o o b-theatre i-theatre i-theatre i-theatre i-theatre o o o o o
嘉禾电影院正在上映的大片	cinemas@query	b-theatre i-theatre i-theatre i-theatre i-theatre o o o o o o o
附近有没有电影院啊？	cinemas@query	o o o o o o o o o o
那你告诉我最新的热门电影吧。	cinemas@query	o o o o o o o o o o o o o o
艺轩电影院最近上映的电影有哪些	cinemas@query	b-theatre i-theatre i-theatre i-theatre i-theatre o o o o o o o o o o
把张三的电话发给李四	message@sendcontacts	o b-name i-name o o o o o b-receiver i-receiver
把上官围的电话发给戴勋	message@sendcontacts	o b-name i-name i-name o o o o o b-receiver i-receiver
陈周的电话号码是多少	telephone@query	b-name i-name o o o o o o o o
添加一条通讯录姓名张守刚号码是13811725158	contacts@create	o o o o o o o o o b-name i-name i-name o o o b-code i-code i-code i-code i-code i-code i-code i-code i-code i-code i-code
素烩汤。	cookbook@query	b-dishname i-dishname i-dishname o
麻辣豆腐怎么做啊？	cookbook@query	b-dishname i-dishname i-dishname i-dishname o o o o o
大薯条怎么做？	cookbook@query	o b-dishname i-dishname o o o o
今晚红烧肉的做法。	cookbook@query	o o b-dishname i-dishname i-dishname o o o o
腊鱼头怎么做？	cookbook@query	b-dishname i-dishname i-dishname o o o o
小军儿炖土豆该怎么做？	cookbook@query	o o o b-dishname i-dishname i-dishname o o o o o
牛肉怎么烧	cookbook@query	b-ingredient i-ingredient o o o
桂林米粉，哦。	cookbook@query	b-dishname i-dishname i-dishname i-dishname o o o
麻婆豆腐怎么做	cookbook@query	b-dishname i-dishname i-dishname i-dishname o o o
艺锅肉怎么做？	cookbook@query	o o b-ingredient o o o o
来做烧卖。	cookbook@query	o o b-dishname i-dishname o
教我煮红烧排骨	cookbook@query	o o o b-dishname i-dishname i-dishname i-dishname
酸菜鱼怎么烧的？	cookbook@query	b-dishname i-dishname i-dishname o o o o o
酱牛肉怎么做	cookbook@query	b-dishname i-dishname i-dishname o o o
你如何做螃蟹？	cookbook@query	o o o o b-ingredient i-ingredient o
放鱼怎么做？	cookbook@query	o b-ingredient o o o o
怎样给宝宝做胡萝卜泥。	cookbook@query	o o o o o o b-dishname i-dishname i-dishname i-dishname o
酒鬼花生怎么做？	cookbook@query	b-dishname i-dishname i-dishname i-dishname o o o o
怎么做番茄汤	cookbook@query	o o o b-dishname i-dishname i-dishname
腰花可以怎么做？	cookbook@query	b-ingredient i-ingredient o o o o o o
了，鸡蛋怎么做？	cookbook@query	o o b-ingredient i-ingredient o o o o
鸡蛋怎么炒最好吃？	cookbook@query	b-ingredient i-ingredient o o o o o o o
鲜肉玉米羹怎么做？	cookbook@query	b-dishname i-dishname i-dishname i-dishname i-dishname o o o o
人心无穷烧肉的做法。	cookbook@query	o o o o b-dishname i-dishname o o o o
酱油汁的做法。	cookbook@query	b-ingredient i-ingredient i-ingredient o o o o
糖醋藕怎么做？	cookbook@query	b-dishname i-dishname i-dishname o o o o
搜索西红柿的做法。	cookbook@query	o o b-ingredient i-ingredient i-ingredient o o o o
土豆怎么做才好吃？	cookbook@query	b-ingredient i-ingredient o o o o o o o
地三鲜怎么做？你？	cookbook@query	b-dishname i-dishname i-dishname o o o o o o
鸡蛋怎么做？	cookbook@query	b-ingredient i-ingredient o o o o
保险，酸辣土豆丝怎么炒？	cookbook@query	o o o b-dishname i-dishname i-dishname i-dishname i-dishname o o o o
怎样煮酸甜排骨。	cookbook@query	o o o b-dishname i-dishname i-dishname i-dishname o
烤鸡翅怎么做呀？	cookbook@query	b-dishname i-dishname i-dishname o o o o o
北京烤鸭做法。	cookbook@query	b-dishname i-dishname i-dishname i-dishname o o o
糖醋排骨怎么做呢	cookbook@query	b-dishname i-dishname i-dishname i-dishname o o o o
糖醋里脊啊，啊	cookbook@query	b-dishname i-dishname i-dishname i-dishname o o o
制作酸梅汤怎么做？	cookbook@query	o o b-dishname i-dishname i-dishname o o o o
咸鸡，的制作方法。	cookbook@query	b-ingredient i-ingredient o o o o o o o
我想听回锅肉做法。	cookbook@query	o o o b-dishname i-dishname i-dishname o o o
啤酒鸭怎么做？	cookbook@query	b-dishname i-dishname i-dishname o o o o
即鱼汤怎么做？	cookbook@query	o b-dishname i-dishname o o o o
板栗如何烧？	cookbook@query	b-ingredient i-ingredient o o o o
怎么做馒头	cookbook@query	o o o b-dishname i-dishname
国画怎样做土豆烧鸡块	cookbook@query	o o o o o b-dishname i-dishname i-dishname i-dishname i-dishname
有油炸酱料怎么做？	cookbook@query	o b-dishname i-dishname i-dishname i-dishname o o o o
面条怎么样煮啊？	cookbook@query	b-ingredient i-ingredient o o o o o o
炖鸡	cookbook@query	b-dishname i-dishname
怎样做面筋	cookbook@query	o o o b-ingredient i-ingredient
腐乳肉怎么做？	cookbook@query	b-dishname i-dishname i-dishname o o o o
鸡煲啊！	cookbook@query	b-dishname i-dishname o o
鱼香茄子怎么做	cookbook@query	b-dishname i-dishname i-dishname i-dishname o o o
帮我搜索一下羊肉面片。	cookbook@query	o o o o o o b-dishname i-dishname i-dishname i-dishname o
汉堡。	cookbook@query	b-dishname i-dishname o
煮水饺。	cookbook@query	o b-dishname i-dishname o
羊肉怎么烧？	cookbook@query	b-ingredient i-ingredient o o o o
梅菜扣肉怎么做啊？	cookbook@query	b-dishname i-dishname i-dishname i-dishname o o o o o
小鸡炖蘑菇的做法爸	cookbook@query	b-dishname i-dishname i-dishname i-dishname i-dishname o o o o
请问牛排怎么做	cookbook@query	o o b-dishname i-dishname o o o
豆豉鲮鱼油麦菜	cookbook@query	b-dishname i-dishname i-dishname i-dishname i-dishname i-dishname i-dishname
日本豆腐的做法。	cookbook@query	b-ingredient i-ingredient i-ingredient i-ingredient o o o o
哈哈，吃了水煮鱼怎么做？	cookbook@query	o o o o o b-dishname i-dishname i-dishname o o o o
我想写一个邮件	email@create	o o o o o o o
我想转发这封邮件	email@forward	o o o o o o o o
发邮件	email@send	o o o
我要写一条邮件	email@create	o o o o o o o
我想全部答复	email@replay_all	o o o o o o
替我回复邮件	email@reply	o o o o o o
给我写一封邮件	email@create	o o o o o o o
北京生活频道节目单	epg@query	b-tvchannel i-tvchannel i-tvchannel i-tvchannel i-tvchannel i-tvchannel o o o
湖南卫视电视节目表	epg@query	b-tvchannel i-tvchannel i-tvchannel i-tvchannel o o o o o
中央三今天有什么节目	epg@query	b-tvchannel i-tvchannel i-tvchannel b-datetime_date i-datetime_date o o o o o
湖南卫视节目录	epg@query	b-tvchannel i-tvchannel i-tvchannel i-tvchannel o o o
淮南电视台综合频道节目。	epg@query	b-tvchannel i-tvchannel i-tvchannel i-tvchannel i-tvchannel i-tvchannel i-tvchannel i-tvchannel i-tvchannel o o o
明天什么节目啊？	epg@query	b-datetime_date i-datetime_date o o b-category i-category o o
现在浙江卫视在放什么节目	epg@query	b-datetime_time i-datetime_time b-tvchannel i-tvchannel i-tvchannel i-tvchannel o o o o o o
浙江卫视今晚有中国好声音吗？	epg@query	b-tvchannel i-tvchannel i-tvchannel i-tvchannel b-datetime_time i-datetime_time o b-name i-name i-name i-name i-name o o
中央一一台有什么节目吗	epg@query	b-tvchannel i-tvchannel i-tvchannel i-tvchannel i-tvchannel o o o o o o
青海卫视频道的节目单	epg@query	b-tvchannel i-tvchannel i-tvchannel i-tvchannel o o o o o o
中央一套昨天的新闻联播	epg@query	b-tvchannel i-tvchannel i-tvchannel i-tvchannel b-datetime_date i-datetime_date o b-name i-name i-name i-name
前天中央一套的节目单	epg@query	b-datetime_date i-datetime_date b-tvchannel i-tvchannel i-tvchannel i-tvchannel o o o o
帮我查下下周演新闻联播	epg@query	o o o b-datetime_date i-datetime_date o o b-name i-name i-name i-name
电视回看安徽卫视	epg@look_back	o o o o b-tvchannel i-tvchannel i-tvchannel i-tvchannel
12月9日北京卫视节目单	epg@query	b-datetime_date i-datetime_date i-datetime_date i-datetime_date i-datetime_date b-tvchannel i-tvchannel i-tvchannel i-tvchannel o o o
财经频道今天有什么节目	epg@query	b-tvchannel i-tvchannel i-tvchannel i-tvchannel b-datetime_date i-datetime_date o o o o o
浙江高清台的节目单	epg@query	b-tvchannel i-tvchannel i-tvchannel i-tvchannel i-tvchannel o o o o
2012年的恐怖电影	video@query	b-datetime_date i-datetime_date i-datetime_date i-datetime_date i-datetime_date o b-tag i-tag b-category i-category
上海去武汉的航班	flight@query	b-startloc_city i-startloc_city o b-endloc_city i-endloc_city o o o
从重庆到武汉的航班	flight@query	o b-startloc_city i-startloc_city o b-endloc_city i-endloc_city o o o
帮我查一下明天广州到长沙的航班	flight@query	o o o o o b-startdate_date i-startdate_date b-startloc_city i-startloc_city o b-endloc_city i-endloc_city o o o
杭州到郑州飞机票	flight@query	b-startloc_city i-startloc_city o b-endloc_city i-endloc_city o o o
我想订8月15晚上北京飞合肥的机票	flight@query	o o o b-startdate_date i-startdate_date i-startdate_date i-startdate_date b-startdate_time i-startdate_time b-startloc_city i-startloc_city o b-endloc_city i-endloc_city o o o
九月二十号广州飞北京的航班	flight@query	b-startdate_date i-startdate_date i-startdate_date i-startdate_date i-startdate_date b-startloc_city i-startloc_city o b-endloc_city i-endloc_city o o o
帮我订明天早晨的机票	flight@query	o o o b-startdate_date i-startdate_date b-startdate_time i-startdate_time o o o
到贵阳的航班。	flight@query	o b-endloc_city i-endloc_city o o o o
后天从深圳到成都的航班	flight@query	b-startdate_date i-startdate_date o b-startloc_city i-startloc_city o b-endloc_city i-endloc_city o o o
今天新余到北京的航班	flight@query	b-startdate_date i-startdate_date b-startloc_city i-startloc_city o b-endloc_city i-endloc_city o o o
查询上海到北京的航班。	flight@query	o o b-startloc_city i-startloc_city o b-endloc_city i-endloc_city o o o o
查询郑州到上海的航班。	flight@query	o o b-startloc_city i-startloc_city o b-endloc_city i-endloc_city o o o o
明天到佛山的航班	flight@query	b-startdate_date i-startdate_date o b-endloc_city i-endloc_city o o o
八月十九号到成都的航班	flight@query	b-startdate_date i-startdate_date i-startdate_date i-startdate_date i-startdate_date o b-endloc_city i-endloc_city o o o
去重庆的机票多少钱。	flight@query	o b-endloc_city i-endloc_city o o o o o o o
潍坊到北京机票明天的	flight@query	b-startloc_city i-startloc_city o b-endloc_city i-endloc_city o o b-startdate_date i-startdate_date o
查一下明天青岛飞往上海的飞机都有哪一些都是几点的	flight@query	o o o b-startdate_date i-startdate_date b-startloc_city i-startloc_city o o b-endloc_city i-endloc_city o o o o o o o o o o o o o
二十五日去深圳的航班	flight@query	b-startdate_date i-startdate_date i-startdate_date i-startdate_date o b-endloc_city i-endloc_city o o o
阑尾炎	health@query	b-keyword i-keyword i-keyword
内痔怎么办？	health@query	b-keyword i-keyword o o o o
腹泻。	health@query	b-keyword i-keyword o
唇腭裂。	health@query	b-keyword i-keyword i-keyword o
高血压怎么办吧	health@query	b-keyword i-keyword i-keyword o o o o
贫血怎么治？	health@query	b-keyword i-keyword o o o o
得了灰指甲怎么办呢？	health@query	o o b-keyword i-keyword i-keyword o o o o o
给我查一下糖尿病如何治疗？	health@query	o o o o o b-keyword i-keyword i-keyword o o o o o
如何治疗脚臭。	health@query	o o o o b-keyword i-keyword o
手癣怎么治疗？	health@query	b-keyword i-keyword o o o o o
小孩子有肺炎的治疗方法有哪些？	health@query	o o o o b-keyword i-keyword o o o o o o o o o
脊髓损伤。	health@query	b-keyword i-keyword i-keyword i-keyword o
烧伤怎么治疗啊？	health@query	b-keyword i-keyword o o o o o o
上一期15选5的中奖号码是多少？	lottery@number_query	b-relissue i-relissue i-relissue b-name i-name i-name i-name o o o o o o o o o
第50000期福彩双色球	lottery@number_query	o b-absissue i-absissue i-absissue i-absissue i-absissue o b-category i-category b-name i-name i-name
帮我买两注双色球	lottery@number_query	o o o o o b-name i-name i-name
查看双色球开奖	lottery@number_query	o o b-name i-name i-name o o
常州在哪	map@position	b-location_city i-location_city o o
薛山西路怎么走	map@route	b-endloc_poi i-endloc_poi i-endloc_poi i-endloc_poi o o o
查一下从上海到安徽东至县的路线	map@route	o o o o b-startloc_city i-startloc_city o b-endloc_province i-endloc_province b-endloc_area i-endloc_area i-endloc_area o o o
龙王庙在哪里	map@position	b-location_poi i-location_poi i-location_poi o o o
从这里去瑞金路怎么走	map@route	o o o o b-endloc_poi i-endloc_poi i-endloc_poi o o o
灌阳县位置	map@position	b-location_area i-location_area i-location_area o o
导航到望江西路上去	map@route	o o o b-endloc_poi i-endloc_poi i-endloc_poi i-endloc_poi o o
武汉理工大学在哪	map@position	b-location_poi i-location_poi i-location_poi i-location_poi i-location_poi i-location_poi o o
搜索凤凰古城位置	map@position	o o b-location_poi i-location_poi i-location_poi i-location_poi o o
从这里去科大讯飞如何去	map@route	o o o o b-endloc_poi i-endloc_poi i-endloc_poi i-endloc_poi o o o
迎宾路在哪	map@position	b-location_poi i-location_poi i-location_poi o o
导航到江门	map@route	o o o b-endloc_city i-endloc_city
云浮在哪里	map@position	b-location_city i-location_city o o o
去汽车东站怎么走	map@route	o b-endloc_poi i-endloc_poi i-endloc_poi i-endloc_poi o o o
导航到石化小学	map@route	o o o b-endloc_poi i-endloc_poi i-endloc_poi i-endloc_poi
沿途的科大讯飞	map@route	o o o b-endloc_poi i-endloc_poi i-endloc_poi i-endloc_poi
到安徽芜湖怎么走	map@route	o b-endloc_province i-endloc_province b-endloc_city i-endloc_city o o o
飞机场怎么走	map@route	b-endloc_poi i-endloc_poi i-endloc_poi o o o
去永康怎么走	map@route	o b-endloc_area i-endloc_area o o o
我要到徐家汇怎么走	map@route	o o o b-endloc_poi i-endloc_poi i-endloc_poi o o o
帮我查一下我所在的位置	map@position	o o o o o o o o o o o
周口在哪里	map@position	b-location_city i-location_city o o o
中超赛事预告，啊！	match@query	b-category i-category o o b-type i-type o o o
下个星期中国足球超级联赛淘汰赛的赛事前瞻	match@query	b-datetime_date i-datetime_date i-datetime_date i-datetime_date b-category i-category i-category i-category i-category i-category i-category i-category o o o o o o o o
篮球赛事预告。	match@query	b-category i-category o o b-type i-type o
中超比分。	match@query	b-category i-category b-type i-type o
中超的比赛预告。	match@query	b-category i-category o o o b-type i-type o
发送短信给黄启超	message@send	o o o o o b-name i-name i-name
给夏磊发短信	message@send	o b-name i-name o o o
给陈易云发短消息	message@send	o b-name i-name i-name o o o o
我要给陈永信息	message@send	o o o b-name i-name o o
发短信呢	message@send	o o o o
给肥老发信息	message@send	o b-name i-name o o o
发送短消息	message@send	o o o o o
给茵茵发短信	message@send	o b-name i-name o o o
给黄卫国发短信	message@send	o b-name i-name i-name o o o
给胡克发短信	message@send	o b-name i-name o o o
给岚岚发短信	message@send	o b-name i-name o o o
发短讯给曹建阳	message@send	o o o o b-name i-name i-name
查看短消息	message@view	o o o o o
发短信给张全三移动的号码我今天请他吃法	message@send	o o o o b-name i-name i-name b-teleoperator i-teleoperator o o o b-content i-content i-content i-content i-content i-content i-content
给徐茶叶发短信	message@send	o b-name i-name i-name o o o
来一首一生最爱。	music@play	o b-song i-song i-song i-song o o o
我要听那首最美的时光	music@play	o o o o o b-song i-song i-song i-song i-song
再来一首飞得更高。	music@play	o o o o b-song i-song i-song i-song o
我要听稻香	music@play	o o o b-song i-song
来首歌吗？	music@play	o o o o o
来一首飞得更高了说完了	music@play	o o o b-song i-song i-song i-song o o o o
播放一首倒带来听一听	music@play	o o o o b-song i-song o o o o
个来一首路灯下的小姑娘。	music@play	o o o o b-song i-song i-song i-song i-song i-song i-song o
我要听流行歌曲	music@play	o o o b-category i-category o o
来一首剑侠情缘	music@play	o o o b-song i-song i-song i-song
哦来一首传奇	music@play	o o o o b-song i-song
胡歌忘记时间	music@play	b-artist i-artist b-song i-song i-song i-song
来一首钟汉良的视觉动物	music@play	o o o b-artist i-artist i-artist o b-song i-song i-song i-song
徐良唱的歌	music@play	b-artist i-artist o o o
赵唱一首歌吧	music@play	o o o o o o
陈奕迅有什么歌啊	music@search	b-artist i-artist i-artist o o o o o
来首青花瓷	music@play	o o b-song i-song i-song
我要点新闻。	news@play	o o o o o o
我要看新闻玩不？	news@play	o o o o o o o o
后天新闻	news@play	b-datetime_date i-datetime_date o o
我想听最新军事新闻。	news@play	o o o o o b-category i-category o o o
我想看新闻。	news@play	o o o o o o
我想听听钓鱼岛的新闻。	news@play	o o o o b-keyword i-keyword i-keyword o o o o
天最新新闻。	news@play	o o o o o o
我要听昆明新闻。	news@play	o o o b-location_city i-location_city o o o
看新闻。	news@play	o o o o
给我找到今天的新闻。	news@play	o o o o b-datetime_date i-datetime_date o o o o
读新闻听。	news@play	o o o o o
温州今天的新闻	news@play	b-location_city i-location_city b-datetime_date i-datetime_date o o o
我想听搜狐新闻	news@play	o o o b-media i-media o o
查一下新闻。	news@play	o o o o o o
辛夷坞原来你还在这里小说	novel@query	b-author i-author i-author b-name i-name i-name i-name i-name i-name i-name o o
陈忠实的爱情小说《白鹿原》	novel@query	b-author i-author i-author o b-category i-category o o o b-name i-name i-name o
都市言情小说何以笙箫默	novel@query	b-category i-category i-category i-category o o b-name i-name i-name i-name i-name
搜一下小说。	novel@query	o o o o o o
给我讲一个长篇小说。	novel@query	o o o o o o o o o o
我要看现代言情小说	novel@query	o o o b-category i-category i-category i-category o o
查询饶雪漫的言情小说	novel@query	o o b-author i-author i-author o b-category i-category o o
来一首李白的诗。	poetry@query	o o o b-author i-author o o o
茅屋为秋风所破歌杜甫。	poetry@query	b-name i-name i-name i-name i-name i-name i-name i-name b-author i-author o
白居易的诗词。	poetry@query	b-author i-author i-author o o o o
背离骚给我听。	poetry@query	o b-name i-name o o o o
给我来首诗。	poetry@default	o o o o o o
买，来一首诗李白的诗。	poetry@query	o o o o o o b-author i-author o o o
背诵悯农。	poetry@query	o o b-name i-name o
读一首毛泽东的诗。	poetry@query	o o o b-author i-author i-author o o o
读一首古诗给我听吧！	poetry@default	o o o o o o o o o o
来一首白居易的诗了。	poetry@query	o o o b-author i-author i-author o o o o
给我朗诵一下岳飞的满江红。	poetry@query	o o o o o o b-author i-author o b-name i-name i-name o
来首山口。	poetry@query	o o b-name i-name o
人死原知万事空下一句是什么？	poetry@query	b-keyword i-keyword i-keyword i-keyword i-keyword i-keyword i-keyword b-queryfield i-queryfield i-queryfield o o o o
念一首唐诗给我听。	poetry@query	o o o b-dynasty o o o o o
搜索腊梅。	poetry@query	o o b-name i-name o
朗诵李白的静夜思。	poetry@query	o o b-author i-author o b-name i-name i-name o
同是天涯沦落人下一句。	poetry@query	b-keyword i-keyword i-keyword i-keyword i-keyword i-keyword i-keyword b-queryfield i-queryfield i-queryfield o
抽刀断水水更流的下一句是什么？	poetry@query	b-keyword i-keyword i-keyword i-keyword i-keyword i-keyword i-keyword o b-queryfield i-queryfield i-queryfield o o o o
来一首水调歌头。	poetry@query	o o o b-name i-name i-name i-name o
让读一下沁园春雪毛泽东。	poetry@query	o o o o b-name i-name i-name i-name b-author i-author i-author o
来时打来首唐诗绝句。	poetry@query	o o o o o b-dynasty o b-name i-name o
刘禹锡的秋词。	poetry@query	b-author i-author i-author o b-name i-name o
给我背一首唐诗李白写的	poetry@query	o o o o o b-dynasty o b-author i-author o o
背首唐诗来听啊！	poetry@query	o o b-dynasty o o o o o
牧童骑黄牛的下一句是什么？	poetry@query	b-keyword i-keyword i-keyword i-keyword i-keyword o b-queryfield i-queryfield i-queryfield o o o o
来一首毛泽东的词。	poetry@query	o o o b-author i-author i-author o o o
请帮我调频105山东人民广播电台生活频道	radio@launch	o o o o o b-code i-code i-code b-name i-name i-name i-name i-name i-name i-name i-name i-name i-name i-name i-name
可以帮我收听安庆新闻综合广播	radio@launch	o o o o o o b-name i-name i-name i-name i-name i-name i-name i-name
请帮我调频90.2连云港经济广播电台	radio@launch	o o o o o b-code i-code i-code i-code b-name i-name i-name i-name i-name i-name i-name i-name i-name
收听安徽广播电台。	radio@launch	o o b-location_province i-location_province b-name i-name i-name i-name o
再猜一个谜语。	riddle@query	o o o o b-category i-category o
来个谜语吧！	riddle@query	o o b-category i-category o o
搜索一个字谜了。	riddle@query	o o o o b-category i-category o o
啊，猜个谜语给我听。	riddle@query	o o o o b-category i-category o o o o
那就来个字谜吧！	riddle@query	o o o o b-category i-category o o
猜谜语，听了。	riddle@query	o b-category i-category o o o o
哥猜个谜语。	riddle@query	o o o b-category i-category o
请给我打一个谜语。	riddle@query	o o o o o o b-category i-category o
我想查询上证指数的股票	stock@query	o o o o b-name i-name i-name i-name o o o
科大讯飞股票价格	stock@query	b-name i-name i-name i-name o o o o
查询中信国安的股票	stock@query	o o b-name i-name i-name i-name o o o
陕西金叶近日的涨幅情况	stock@riserate_query	b-name i-name i-name i-name o o o o o o o
中国联通的股票涨还是跌	stock@riserate_query	b-name i-name i-name i-name o o o o o o o
查询东方集团的股票	stock@query	o o b-name i-name i-name i-name o o o
苹果公司股票每股多少钱啊	stock@query	b-name i-name i-name i-name o o o o o o o o
阿勋中集集团的股票	stock@query	o o b-name i-name i-name i-name o o o
查询重庆水务股票	stock@query	o o b-name i-name i-name i-name o o
亚洲能源物流股票	stock@query	b-name i-name i-name i-name i-name i-name o o
帮我查一下江西铜业股票	stock@query	o o o o o b-name i-name i-name i-name o o
打电话给一十一	telephone@dial	o o o o b-name i-name i-name
打电话给谢文豪	telephone@dial	o o o o b-name i-name i-name
打电话给吴荣因	telephone@dial	o o o o b-name i-name i-name
呼叫小惠	telephone@dial	o o b-name i-name
呼叫老公	telephone@dial	o o b-name i-name
打电话给陈正成	telephone@dial	o o o o b-name i-name i-name
打电话给何健	telephone@dial	o o o o b-name i-name
打电话给陈永聪	telephone@dial	o o o o b-name i-name i-name
打电话麦亚伦	telephone@dial	o o o b-name i-name i-name
打电话给地瓜	telephone@dial	o o o o b-name i-name
打电话给王大头	telephone@dial	o o o o b-name i-name i-name
呼叫晚欲强	telephone@dial	o o b-name i-name i-name
打电话给斌少	telephone@dial	o o o o b-name i-name
打电话零八	telephone@dial	o o o o o
晋江到温州的火车票	train@query	b-startloc_area i-startloc_area o b-endloc_city i-endloc_city o o o o
查一下南京到上海的火车注意谢谢	train@query	o o o b-startloc_city i-startloc_city o b-endloc_city i-endloc_city o o o o o o o
从东莞到厦门的火车票	train@query	o b-startloc_city i-startloc_city o b-endloc_city i-endloc_city o o o o
查宁波到北京的火车票	train@query	o b-startloc_city i-startloc_city o b-endloc_city i-endloc_city o o o o
搜索郑州到南阳的火车票	train@query	o o b-startloc_city i-startloc_city o b-endloc_city i-endloc_city o o o o
我要订一张到宁波的动车票	train@query	o o o o o o b-endloc_city i-endloc_city o b-category i-category o
查一下杭州到宁波的火车票	train@query	o o o b-startloc_city i-startloc_city o b-endloc_city i-endloc_city o o o o
从武汉到杭州的火车	train@query	o b-startloc_city i-startloc_city o b-endloc_city i-endloc_city o o o
帮我查一下淮安到石家庄的火车	train@query	o o o o o b-startloc_city i-startloc_city o b-endloc_city i-endloc_city i-endloc_city o o o
去烟台的火车	train@query	o b-endloc_city i-endloc_city o o o
查一下吉安至武汉的火车	train@query	o o o b-startloc_city i-startloc_city o b-endloc_city i-endloc_city o o o
查一下广州到信阳的火车票	train@query	o o o b-startloc_city i-startloc_city o b-endloc_city i-endloc_city o o o o
帮我搜索一下宜春到长沙的火车	train@query	o o o o o o b-startloc_city i-startloc_city o b-endloc_city i-endloc_city o o o
帮我定一张去镇江的动车票	train@query	o o o o o o b-endloc_city i-endloc_city o b-category i-category o
郑州到许昌的火车	train@query	b-startloc_city i-startloc_city o b-endloc_city i-endloc_city o o o
查询武汉到茂名的火车	train@query	o o b-startloc_city i-startloc_city o b-endloc_city i-endloc_city o o o
十堰至武汉火车票	train@query	b-startloc_city i-startloc_city o b-endloc_city i-endloc_city o o o
姜堰到南京的火车	train@query	b-startloc_area i-startloc_area o b-endloc_city i-endloc_city o o o
中国移动通信的英语怎么说	translation@translation	b-content i-content i-content i-content i-content i-content o b-target i-target o o o
我想出去旅游英文怎么说	translation@translation	b-content i-content i-content i-content i-content i-content b-target i-target o o o
翻译这个多少钱	translation@translation	o o b-content i-content i-content i-content i-content
我要买电脑的英语怎么说	translation@translation	b-content i-content i-content i-content i-content o b-target i-target o o o
我们一起去玩吧用英文怎么说	translation@translation	b-content i-content i-content i-content i-content i-content i-content o b-target i-target o o o
买东西翻译成英语	translation@translation	b-content i-content i-content o o o b-target i-target
完毕用英文怎么说	translation@translation	b-content i-content o b-target i-target o o o
乳房的英语怎么说	translation@translation	b-content i-content o b-target i-target o o o
翻译我是一只狗	translation@translation	o o b-content i-content i-content i-content i-content
翻译睡觉了	translation@translation	o o b-content i-content i-content
说话的英文怎么写	translation@translation	b-content i-content o b-target i-target o o o
明天有什么活动用英语怎么讲	translation@translation	b-content i-content i-content i-content i-content i-content i-content o b-target i-target o o o
用英语怎么讲	translation@translation	b-content b-target i-target o o o
翻译我今天要去打网球	translation@translation	o o b-content i-content i-content i-content i-content i-content i-content i-content
电焊机用英语怎么说	translation@translation	b-content i-content i-content o b-target i-target o o o
点击说话的英语怎么写	translation@translation	b-content i-content i-content i-content o b-target i-target o o o
高清广东台	tvchannel@play	b-resolution i-resolution b-name i-name i-name
cctv6电影	tvchannel@play	b-name i-name i-name i-name i-name i-name i-name
切换浦口新闻综合频道	tvchannel@play	o o b-name i-name i-name i-name i-name i-name i-name i-name
科教频道	tvchannel@play	b-category i-category o o
午夜凶铃	video@query	b-name i-name i-name i-name
播放落日批示	video@query	o o b-name i-name o o
福尔摩斯探案集	video@query	b-name i-name i-name i-name i-name i-name i-name
最新电影	video@query	b-timedescr i-timedescr b-category i-category
看毛泽东在武汉的故事	video@query	o b-name i-name i-name i-name i-name i-name i-name i-name i-name
一路向西	video@query	b-name i-name i-name i-name
叶落长安电视剧	video@query	b-name i-name i-name i-name b-category i-category i-category
穷孩子富孩子	video@query	b-name i-name i-name i-name i-name i-name
神兵小将	video@query	b-name i-name i-name i-name
需要你帮我推荐一下电影	video@query	o o o o o o o o o b-category i-category
古墓丽影	video@query	b-name i-name i-name i-name
天才碰麻瓜	video@query	b-name i-name i-name i-name i-name
死亡笔记	video@query	b-name i-name i-name i-name
封神榜	video@query	b-name i-name i-name
美国电影少年派的奇幻漂流	video@query	b-area i-area b-category i-category b-name i-name i-name i-name i-name i-name i-name i-name
共同关注	video@query	b-name i-name i-name i-name
电视剧粘豆包	video@query	b-category i-category i-category b-name i-name i-name
最新有什么热门电影	video@query	b-timedescr i-timedescr o o o b-popularity i-popularity b-category i-category
熊出没啊	video@query	b-name i-name i-name o
封神太子	app@launch	b-name i-name i-name i-name
粉红女郎	video@query	b-name i-name i-name i-name
你给我推荐个电影	video@query	o o o o o o b-category i-category
泰国的节目	video@query	b-area i-area o b-category i-category
动作电影	video@query	b-tag i-tag b-category i-category
我要看综艺	video@query	o o o b-tag i-tag
给我搜个电影	video@query	o o o o b-category i-category
中国霸王花	video@query	b-name i-name i-name i-name i-name
新水浒传	video@query	b-name i-name i-name i-name
抬头见喜	video@query	b-name i-name i-name i-name
我要看巴拉小魔仙	video@query	o o o b-name i-name i-name i-name i-name
超级战舰电影	video@query	b-name i-name i-name i-name b-category i-category
我想看电影搜索	video@query	o o o b-category i-category b-name i-name
2012年美国公告牌音乐大奖颁奖礼	video@query	b-datetime_date i-datetime_date i-datetime_date i-datetime_date i-datetime_date b-name i-name i-name i-name i-name i-name i-name i-name i-name i-name i-name i-name
喂我想看电影喂	video@query	o o o o b-category i-category o
虎胆龙威	video@query	b-name i-name i-name i-name
那金花和她的女婿	video@query	b-name i-name i-name i-name i-name i-name i-name i-name
今天温度是多少	weather@query	b-datetime_date i-datetime_date b-subfocus i-subfocus o o o
魔神战记	app@launch	b-name i-name i-name i-name
打开苹果公司的官方网站	website@open	o o b-name i-name i-name i-name i-name i-name i-name i-name i-name
打开五五两性网站	website@open	o o b-name i-name i-name i-name i-name i-name
请帮我打开网站	website@open	o o o o o o o
打开中关村在线网	website@open	o o b-name i-name i-name i-name i-name o
请打开网页	website@open	o o o o o
我要上中学学科网	website@open	o o o b-name i-name i-name i-name i-name
美女啊帮我打开网页	website@open	o o o o o o o o o
打开骏网一卡通	website@open	o o b-name i-name i-name i-name i-name
打开谷歌wap	website@open	o o b-name i-name o o o
打开熊猫看书	app@launch	o o b-name i-name i-name i-name
钛备份	app@launch	b-name i-name i-name
打开sky电话	app@launch	o o b-name i-name i-name i-name i-name
帮我找菜单	app@query	o o o b-name i-name
找愤怒的小鸟	app@query	o b-name i-name i-name i-name i-name
我把相机打开	app@launch	o o b-name i-name o o
打开uc浏览器v八	app@launch	o o b-name i-name i-name i-name i-name i-name i-name
打开qq登陆到聊天模式	app@launch	o o b-name i-name o o o o o o o
打开个性闹钟	app@launch	o o b-name i-name i-name i-name
国际象棋开局	app@launch	b-name i-name i-name i-name o o
搜索声控安卓软件	app@query	o o b-name i-name i-name i-name o o
搜索机锋市场	app@query	o o b-name i-name i-name i-name
进入设置菜单	app@launch	o o b-name i-name o o
打开应用程序钱包	app@launch	o o o o o o b-name i-name
赶集	app@launch	b-name i-name
我想上qq了	app@launch	o o o b-name i-name o
金山词霸	app@launch	b-name i-name i-name i-name
下载飞信	app@download	o o b-name i-name
嗯打开相机	app@launch	o o o b-name i-name
打开uc浏览器	app@launch	o o b-name i-name i-name i-name i-name
打开qq找杨佳艺	app@launch	o o b-name i-name o o o o
百度百科	app@launch	b-name i-name i-name i-name
打开会说话的汤姆猫	app@launch	o o b-name i-name i-name i-name i-name i-name i-name
搜索京东商城	app@query	o o b-name i-name i-name i-name
打开酷狗并随机播放	app@launch	o o b-name i-name o o o o o
打开天天动听并开始播放音乐	app@launch	o o b-name i-name i-name i-name o o o o o o o
酷狗音乐盒	app@launch	b-name i-name i-name i-name i-name
打开应用漫画	app@launch	o o o o b-name i-name
启动qq浏览器	app@launch	o o b-name i-name i-name i-name i-name
打开系统软件清理	app@launch	o o b-name i-name i-name i-name i-name i-name
打开相机我想你	app@launch	o o b-name i-name o o o
开启通讯录	app@launch	o o b-name i-name i-name
有道词典	app@launch	b-name i-name i-name i-name
打开搜狐微博	app@launch	o o b-name i-name i-name i-name
打开语音软件	app@launch	o o b-name i-name o o
下载汉化软件	app@download	o o b-name i-name o o
怎么坐车去广州？	bus@query	o o o o o b-dest i-dest o
从西安到石嘴山的汽车票。	bus@query	o b-src i-src o b-dest i-dest i-dest o o o o o
在菏泽怎么坐去北京的车。	bus@query	o b-src i-src o o o o b-dest i-dest o o o
宁波到杭州的汽车	bus@query	b-src i-src o b-dest i-dest o o o
宁波到岳阳的汽车。	bus@query	b-src i-src o b-dest i-dest o o o o
合肥到上海可以到哪坐车？	bus@query	b-src i-src o b-dest i-dest o o o o o o o
长沙到怀化的汽车。	bus@query	b-src i-src o b-dest i-dest o o o o
从温州到西安的汽车。	bus@query	o b-src i-src o b-dest i-dest o o o o
上海到合肥怎么坐汽车？	bus@query	b-src i-src o b-dest i-dest o o o o o o
从中山到西安的汽车。	bus@query	o b-src i-src o b-dest i-dest o o o o
九江到景德镇的汽车。	bus@query	b-src i-src o b-dest i-dest i-dest o o o o
吉林到大连的车。	bus@query	b-src i-src o b-dest i-dest o o o
查一下运城到临汾的汽车。	bus@query	o o o b-src i-src o b-dest i-dest o o o o
上海到合肥可以到哪坐车	bus@query	b-src i-src o b-dest i-dest o o o o o o
济南去聊城的汽车。	bus@query	b-src i-src o b-dest i-dest o o o o
请查询天津市到哈尔滨的车。	bus@query	o o o b-src i-src i-src o b-dest i-dest i-dest o o o
你再给我推荐几本书	novel@query	o o o o o o o o o
我去烟台有高铁吗	train@query	o o b-endloc_city i-endloc_city o b-category i-category o
有什么好听的歌	music@search	o o o b-category i-category o o
我给你打电话行吗	telephone@dial	o o o o o o o o
谁为含愁独不见	poetry@query	b-keyword i-keyword i-keyword i-keyword i-keyword i-keyword i-keyword
你会查火车票么	train@query	o o o o o o o
讲个笑话吗	train@query	o o o o o
查询恒光电影院即将上映的电影	cinemas@query	o o b-theatre i-theatre i-theatre i-theatre i-theatre o o o o o o o
我想知道环球影视明天播放什么电影	cinemas@query	o o o o o o o o b-datetime_date i-datetime_date o o o o o o
热门电影有哪些啊？	cinemas@query	o o o o o o o o o
有没有新出的电影了。	cinemas@query	o o o o o o o o o o
最近的新电影有哪些？	cinemas@query	o o o o o o o o o o
最新的热门电影是什么呀？	cinemas@query	o o o o o o o o o o o o
电影院有什么电影？	cinemas@query	o o o o o o o o o
搜索一下热门电影。	cinemas@query	o o o o o o o o o
查询众乐电影院最热门的电影	cinemas@query	o o b-theatre i-theatre i-theatre i-theatre i-theatre o o o o o o
最近有什么新片子？	cinemas@query	o o o o o b-timedescr o o o
查一查上影电影院即将上映的影片	cinemas@query	o o o o o o o o o o o o o o o
哦哦，查一下香港最新上映电影。	cinemas@query	o o o o o o b-location_city i-location_city o o o o o o o
找下最近最热播的电影。	cinemas@query	o o o o o o o o o o o
给我查一下最近在播哪些电影	cinemas@query	o o o o o o o o o o o o o
我要看热门电影。	cinemas@query	o o o o o o o o
搜索热门电影。	cinemas@query	o o o o o o o
那你查一下最近的热门电影是什么？	video@query	o o o o o b-timedescr i-timedescr o b-popularity i-popularity b-category i-category o o o o
最近有什么新上映的电影啊？	cinemas@query	o o o o o o o o o o o o o
把张玉娟的手机号码发送给吴伟	message@sendcontacts	o b-name i-name i-name o b-category i-category o o o o o b-receiver i-receiver
潘靖的电话是多少	telephone@query	b-name i-name o o o o o o
新建联系人天天	contacts@create	o o o o o b-name i-name
把小新的号码发给徐云蔚	message@sendcontacts	o b-name i-name o o o o o b-receiver i-receiver i-receiver
把徐程的电话发给吴芳	message@sendcontacts	o b-name i-name o o o o o b-receiver i-receiver
把哥哥的电话发给殷龙	message@sendcontacts	o b-name i-name o o o o o b-receiver i-receiver
把李文鼎的号码发给谢服全	message@sendcontacts	o b-name i-name i-name o o o o o b-receiver i-receiver i-receiver
查看婷婷的号码	contacts@query	o o b-name i-name o o o
周慧的电话。	contacts@query	b-name i-name o o o o
把唐玉明的手机号码发给李康	message@sendcontacts	o b-name i-name i-name o b-category i-category o o o o b-receiver i-receiver
查看王老师的号码	telephone@query	o o b-name i-name i-name o o o
新建联系人18622625490	contacts@create	o o o o o b-code i-code i-code i-code i-code i-code i-code i-code i-code i-code i-code
把李志强的号码发给贾洪鉴	message@sendcontacts	o b-name i-name i-name o o o o o b-receiver i-receiver i-receiver
查寻标兵的号码	telephone@query	o b-name i-name i-name o o o
把许琦彪的号码发给徐鹏	message@sendcontacts	o b-name i-name i-name o o o o o b-receiver i-receiver
添加一条通讯录姓名葛勇手机号码189571642496	contacts@create	o o o o o o o o o b-name i-name o o o o b-code i-code i-code i-code i-code i-code i-code i-code i-code i-code i-code i-code
把张新涛电话发给常胜宾	message@sendcontacts	o b-name i-name i-name o o o o b-receiver i-receiver i-receiver
请问意大利面怎么做	cookbook@query	o o b-dishname i-dishname i-dishname i-dishname o o o
怎么做卤猪脚	cookbook@query	o o o b-dishname i-dishname i-dishname
烤肉串。	cookbook@query	b-dishname i-dishname i-dishname o
油焖大虾怎么做	cookbook@query	b-dishname i-dishname i-dishname i-dishname o o o
简单的，糖醋排骨怎么做？	cookbook@query	o o o o b-dishname i-dishname i-dishname i-dishname o o o o
米粉怎么炒？	cookbook@query	b-ingredient i-ingredient o o o o
牛骨汤	cookbook@query	b-dishname i-dishname i-dishname
冷面的做法。	cookbook@query	b-ingredient i-ingredient o o o o
蛋炒饭怎么煮	cookbook@query	b-dishname i-dishname i-dishname o o o
扁豆豆角怎么烧？	cookbook@query	o b-ingredient i-ingredient o o o o o
山寨鱼怎么做？	cookbook@query	b-dishname i-dishname i-dishname o o o o
怎么炒南瓜？	cookbook@query	o o b-dishname i-dishname i-dishname o
能山药怎么做？	cookbook@query	o b-ingredient i-ingredient o o o o
瞌睡鱼怎么做？	cookbook@query	o o b-ingredient o o o o
蒸鱼。	cookbook@query	b-dishname i-dishname o
盐水鸭怎么做？	cookbook@query	b-dishname i-dishname i-dishname o o o o
葱爆羊肉的做法。	cookbook@query	b-dishname i-dishname i-dishname i-dishname o o o o
冯沙排骨怎么做？	cookbook@query	o o b-ingredient i-ingredient o o o o
给我讲个笑话吧，鱼香肉丝怎么做？	cookbook@query	o o o o o o o o b-dishname i-dishname i-dishname i-dishname o o o o
炖鲢鱼怎么做？	cookbook@query	b-dishname i-dishname i-dishname o o o o
孙翠鱼怎么做？	cookbook@query	b-ingredient i-ingredient i-ingredient o o o o
大骨汤的做法。	cookbook@query	b-ingredient i-ingredient i-ingredient o o o o
陈醋排骨的做法。	cookbook@query	o o b-ingredient i-ingredient o o o o
辣酸菜鱼怎么做了。	cookbook@query	b-dishname i-dishname i-dishname b-ingredient o o o o o
披萨的做法	cookbook@query	b-dishname i-dishname o o o
酱茄条做法。	cookbook@query	b-dishname i-dishname i-dishname o o o
炒鸡蛋，需要，哪些材料？	cookbook@query	b-dishname i-dishname i-dishname o o o o o o o o o
你真笨，是四喜丸子怎么做了。	cookbook@query	o o o o o b-dishname i-dishname i-dishname i-dishname o o o o o
鸽子，怎么做最好吃？	cookbook@query	b-ingredient i-ingredient o o o o o o o o
白灼菜心怎么做？	cookbook@query	b-dishname i-dishname i-dishname i-dishname o o o o
菠萝咕老肉的做法	cookbook@query	b-dishname i-dishname i-dishname i-dishname i-dishname o o o
炒四季豆。	cookbook@query	b-dishname i-dishname i-dishname i-dishname o
麻辣烫做法。	cookbook@query	b-dishname i-dishname i-dishname o o o
凉拌海带	cookbook@query	b-dishname i-dishname i-dishname i-dishname
鱼香肉丝，怎么做得？	cookbook@query	b-dishname i-dishname i-dishname i-dishname o o o o o o
登录不行，做烧鸡公学，我爱你！	cookbook@query	o o o o o o b-dishname i-dishname i-dishname o o o o o o
帮我搜索一下有什么家常菜？	cookbook@query	o o o o o o o o o b-keyword i-keyword i-keyword o
怎么炒番茄炒？	cookbook@query	o o b-dishname i-dishname i-dishname o o
你会不会做蛋糕只能回答哦。	cookbook@query	o o o o o b-dishname i-dishname o o o o o o
南瓜饼的做法。	cookbook@query	b-ingredient i-ingredient i-ingredient o o o o
水饺的做法。	cookbook@query	b-dishname i-dishname o o o o
白灼基尾虾的做法。	cookbook@query	b-dishname i-dishname i-dishname i-dishname i-dishname o o o o
海参怎么做？	cookbook@query	b-ingredient i-ingredient o o o o
还路阻少茶汤的做法。	cookbook@query	o o o o b-dishname i-dishname o o o o
银耳莲子羹。	cookbook@query	b-dishname i-dishname i-dishname i-dishname i-dishname o
帮我查一下可乐鸡翅怎么做？	cookbook@query	o o o o o b-dishname i-dishname i-dishname i-dishname o o o o
水果沙拉怎么做？	cookbook@query	b-dishname i-dishname i-dishname i-dishname o o o o
赵包子怎么做的，你？	cookbook@query	o b-dishname i-dishname o o o o o o o
故宫鱼怎么做？	cookbook@query	b-ingredient i-ingredient i-ingredient o o o o
冰糖葫芦怎么做？你？女子。	cookbook@query	b-dishname i-dishname i-dishname i-dishname o o o o o o o o o
爆炒猪肝怎么做？	cookbook@query	b-dishname i-dishname i-dishname i-dishname o o o o
如何做芝麻糊。	cookbook@query	o o o b-dishname i-dishname i-dishname o
不蒸了牛肉丸	cookbook@query	o o o b-dishname i-dishname i-dishname
做鱼怎么做？	cookbook@query	o b-ingredient o o o o
黄豆猪蹄汤。	cookbook@query	b-dishname i-dishname i-dishname i-dishname i-dishname o
嗯，知道红烧肉怎么做？	cookbook@query	o o o o b-dishname i-dishname i-dishname o o o o
鸭蛋怎么腌？	cookbook@query	b-ingredient i-ingredient o o o o
土豆炒肉丝的做法	cookbook@query	b-dishname i-dishname i-dishname i-dishname i-dishname o o o
馒头怎么做吗？	cookbook@query	b-dishname i-dishname o o o o o
要怎么煮饭。	cookbook@query	o o o o b-dishname o
怎么样？做红烧肉。	cookbook@query	o o o o o b-dishname i-dishname i-dishname o
啥婆豆腐的制作方法	cookbook@query	o o b-ingredient i-ingredient o o o o o
如何做西红柿炒蛋。	cookbook@query	o o o b-dishname i-dishname i-dishname i-dishname i-dishname o
白面粉可以怎样做饼？	cookbook@query	o o o o o o o o b-ingredient o
回锅肉做法。	cookbook@query	b-dishname i-dishname i-dishname o o o
土豆的做法	cookbook@query	b-ingredient i-ingredient o o o
鱼要怎么煮才好吃	cookbook@query	b-ingredient o o o o o o o
手抓饼的做法。	cookbook@query	b-dishname i-dishname i-dishname o o o o
怎样炒肉。	cookbook@query	o o b-dishname i-dishname o
土豆粉怎么做？	cookbook@query	b-ingredient i-ingredient i-ingredient o o o o
怎么做炸鸡	cookbook@query	o o o b-dishname i-dishname
怎么烧西红柿炒蛋	cookbook@query	o o o b-dishname i-dishname i-dishname i-dishname i-dishname
我说白鱼怎么做	cookbook@query	o o b-ingredient i-ingredient o o o
面包的配方。	cookbook@query	b-dishname i-dishname o o o o
夫妻肺片怎么做？	cookbook@query	b-dishname i-dishname i-dishname i-dishname o o o o
凉皮的制作方法。	cookbook@query	b-dishname i-dishname o o o o o o
可乐鸡翅怎么做呀晚点告诉我。	cookbook@query	b-dishname i-dishname i-dishname i-dishname o o o o o o o o o o
怎么做鱼呢？	cookbook@query	o o o b-ingredient o o
我要操虾米的做法。	cookbook@query	o o o b-ingredient i-ingredient o o o o
怎么做洋葱炒蛋？	cookbook@query	o o o b-dishname i-dishname i-dishname i-dishname o
烤牛排怎么做？	cookbook@query	b-dishname i-dishname i-dishname o o o o
搜索，西米露的做法。	cookbook@query	o o o b-dishname i-dishname i-dishname o o o o
红烧猪蹄怎么做	cookbook@query	b-dishname i-dishname i-dishname i-dishname o o o
葫芦鸡怎么做？	cookbook@query	b-dishname i-dishname i-dishname o o o o
四川美食。	cookbook@query	b-keyword i-keyword i-keyword i-keyword o
帮我找一下凉拌海蜇的做法。	cookbook@query	o o o o o b-dishname i-dishname i-dishname i-dishname o o o o
然后等你杀猪菜怎么做？	cookbook@query	o o o o b-dishname i-dishname i-dishname o o o o
红烧土豆怎么烧？	cookbook@query	b-dishname i-dishname i-dishname i-dishname o o o o
川崎玫瑰的制作方法	cookbook@query	o o b-ingredient i-ingredient o o o o o
番红烧肉的做法。	cookbook@query	o b-dishname i-dishname i-dishname o o o o
罐焖牛肉怎么做？	cookbook@query	o b-dishname i-dishname i-dishname o o o o
石螺怎么煮	cookbook@query	b-ingredient i-ingredient o o o
西红柿炒蛋怎么煮？	cookbook@query	b-dishname i-dishname i-dishname i-dishname i-dishname o o o o
甲鱼，邓鸡，如何制作。	cookbook@query	o o o o b-ingredient o o o o o o
金酱肉丝的做法	cookbook@query	b-dishname i-dishname i-dishname i-dishname o o o
烤鸡翅怎么做？	cookbook@query	b-dishname i-dishname i-dishname o o o o
西兰花怎么做？	cookbook@query	b-ingredient i-ingredient i-ingredient o o o o
新奥尔良烤翅的做法	cookbook@query	b-dishname i-dishname i-dishname i-dishname i-dishname i-dishname o o o
鱼香肉丝肉怎么做？	cookbook@query	b-dishname i-dishname i-dishname i-dishname o o o o o
如何做煎饼。	cookbook@query	o o o b-dishname i-dishname o
语音火锅怎么做啊？啊？	cookbook@query	o o b-dishname i-dishname o o o o o o o
猪肚鸡怎么做啊？	cookbook@query	b-dishname i-dishname i-dishname o o o o o
糖醋鲤鱼怎么做？而？	cookbook@query	b-dishname i-dishname i-dishname i-dishname o o o o o o
西红柿炒鸡蛋做法。	cookbook@query	b-dishname i-dishname i-dishname i-dishname i-dishname i-dishname o o o
说话，给我搜一下做苹果麦片粥是怎么做啊？	cookbook@query	o o o o o o o o o b-dishname i-dishname i-dishname i-dishname i-dishname o o o o o o
慕斯的做法。	cookbook@query	b-ingredient i-ingredient o o o o
蒜苔的做法	cookbook@query	b-ingredient i-ingredient o o o
给蛋炒饭怎么做？	cookbook@query	o b-dishname i-dishname i-dishname o o o o
铁板烧怎么做？	cookbook@query	b-dishname i-dishname i-dishname o o o o
坐宫保鸡丁需要哪些材料？	cookbook@query	o b-dishname i-dishname i-dishname i-dishname o o o o o o o
草虾尾怎样做。	cookbook@query	o b-ingredient i-ingredient o o o o
苦瓜要怎么做比较好吃	cookbook@query	b-ingredient i-ingredient o o o o o o o o
肉肉怎么腌制？	cookbook@query	b-ingredient i-ingredient o o o o o
你酸辣土豆丝怎么做？	cookbook@query	o b-dishname i-dishname i-dishname i-dishname i-dishname o o o o
红烧排骨怎么做的吗？	cookbook@query	b-dishname i-dishname i-dishname i-dishname o o o o o o
我说铁锅炖羊肉怎么做？	cookbook@query	o o b-utensil i-utensil b-dishname i-dishname i-dishname o o o o
酸菜是怎么做的可以用塑料布。	cookbook@query	b-ingredient i-ingredient o o o o o o o o o o o o
怎么做煎饼？	cookbook@query	o o o b-dishname i-dishname o
鱼的做法	cookbook@query	b-ingredient o o o
蛋糕可以做蛋糕吗？	cookbook@query	b-dishname i-dishname o o o o o o o
醉虾的做法。	cookbook@query	b-dishname i-dishname o o o o
做糖醋排骨	cookbook@query	o b-dishname i-dishname i-dishname i-dishname
咖喱牛腩怎么做	cookbook@query	b-dishname i-dishname i-dishname i-dishname o o o
小杰炖蘑菇怎么做？	cookbook@query	o o b-dishname i-dishname i-dishname o o o o
土豆饼怎么做啊？	cookbook@query	b-dishname i-dishname i-dishname o o o o o
排骨怎么弄才好吃？	cookbook@query	b-ingredient i-ingredient o o o o o o o
做红烧肉要哪些材料呀！	cookbook@query	o b-dishname i-dishname i-dishname o o o o o o o
王志排骨怎么做	cookbook@query	o o b-ingredient i-ingredient o o o
啊，青椒炒蛋。	cookbook@query	o o b-dishname i-dishname i-dishname i-dishname o
我想知道皮蛋瘦肉粥是怎么做的	cookbook@query	o o o o b-dishname i-dishname i-dishname i-dishname i-dishname o o o o o
猪舌头怎么做比较啊子？	cookbook@query	b-ingredient i-ingredient i-ingredient o o o o o o o o
怎么做京酱肉丝。	cookbook@query	o o o b-dishname i-dishname i-dishname i-dishname o
福寿鱼做法。	cookbook@query	b-ingredient i-ingredient i-ingredient o o o
鱼香肉丝，怎么做？不？	cookbook@query	b-dishname i-dishname i-dishname i-dishname o o o o o o o
教我怎么做红烧肉	cookbook@query	o o o o o b-dishname i-dishname i-dishname
请告诉我清蒸桂鱼怎么做？	cookbook@query	o o o o b-dishname i-dishname i-dishname i-dishname o o o o
基尾虾怎么做？	cookbook@query	b-ingredient i-ingredient i-ingredient o o o o
煲鸡汤呢	cookbook@query	b-dishname i-dishname i-dishname o
凉菜是怎么做的？	cookbook@query	b-keyword i-keyword o o o o o o
那烤箱做面包怎么做？	cookbook@query	o o o o b-dishname i-dishname o o o o
民间小炒肉的做法。	cookbook@query	o o b-dishname i-dishname i-dishname o o o o
昌鱼的做法	cookbook@query	b-ingredient i-ingredient o o o
怎么做冰激凌？	cookbook@query	o o o b-dishname i-dishname i-dishname o
鸡怎么做才好吃？	cookbook@query	b-ingredient o o o o o o o
凉拌海蜇怎么做好吃？	cookbook@query	b-dishname i-dishname i-dishname i-dishname o o o o o o
如何煮牛肉饭。	cookbook@query	o o b-dishname i-dishname i-dishname i-dishname o
说萝卜怎么做？	cookbook@query	o b-ingredient i-ingredient o o o o
红烧排骨怎么做？啊？	cookbook@query	b-dishname i-dishname i-dishname i-dishname o o o o o o
海星的做法。	cookbook@query	b-ingredient i-ingredient o o o o
阳澄湖大闸蟹的做法。	cookbook@query	b-dishname i-dishname i-dishname i-dishname i-dishname i-dishname o o o o
肉沫茄子，怎么做？	cookbook@query	b-dishname i-dishname i-dishname i-dishname o o o o o
虾仁饭。	cookbook@query	b-dishname i-dishname i-dishname o
蚝油生菜的做法。	cookbook@query	b-dishname i-dishname i-dishname i-dishname o o o o
馄炖怎么做？	cookbook@query	b-dishname i-dishname o o o o
做红酒怎么做啊？	cookbook@query	o b-ingredient i-ingredient o o o o o
土豆烧肉。	cookbook@query	b-dishname i-dishname i-dishname i-dishname o
请帮我找一下酸菜鱼的做法	cookbook@query	o o o o o o b-dishname i-dishname i-dishname o o o
猪肉怎么做？	cookbook@query	b-ingredient i-ingredient o o o o
鱼香肉丝，怎么做？买？	cookbook@query	b-dishname i-dishname i-dishname i-dishname o o o o o o o
炖肉	cookbook@query	b-dishname i-dishname
过油肉土豆片怎么做？	cookbook@query	b-dishname i-dishname i-dishname i-dishname i-dishname i-dishname o o o o
烧排骨汤需要什么调料？	cookbook@query	b-dishname i-dishname i-dishname i-dishname o o o o o o o
草莓芒果西米露。	cookbook@query	b-dishname i-dishname i-dishname i-dishname i-dishname i-dishname i-dishname o
米饭怎么做	cookbook@query	b-dishname i-dishname o o o
怎样做糖醋排骨时，去吃饭洗澡了。	cookbook@query	o o o b-dishname i-dishname i-dishname i-dishname o o o o o o o o o
臭豆腐汤怎么烧？	cookbook@query	b-dishname i-dishname i-dishname i-dishname o o o o
想做蛋糕。	cookbook@query	o o b-dishname i-dishname o
瘦肉粥。	cookbook@query	b-dishname i-dishname i-dishname o
白切鸡怎么做啊？	cookbook@query	b-dishname i-dishname i-dishname o o o o o
培根金针菇怎么做？	cookbook@query	b-dishname i-dishname i-dishname i-dishname i-dishname o o o o
米粉肉怎么做？	cookbook@query	b-dishname i-dishname i-dishname o o o o
做面包的配方。	cookbook@query	o b-dishname i-dishname o o o o
教我做馒头。	cookbook@query	o o o b-dishname i-dishname o
怎么做水煮鱼店？	cookbook@query	o o o b-dishname i-dishname i-dishname o o
久久鸭怎么做？	cookbook@query	b-dishnamet i-dishnamet i-dishnamet o o o o
送黄炒鸡蛋怎么做？	cookbook@query	o o b-dishname i-dishname i-dishname o o o o
猪肉灌汤包怎么做？	cookbook@query	b-dishname i-dishname i-dishname i-dishname i-dishname o o o o
秋葵怎么做？	cookbook@query	b-ingredient i-ingredient o o o o
螃蟹怎么蒸？	cookbook@query	b-ingredient i-ingredient o o o o
腊鱼。	cookbook@query	b-dishname i-dishname o
自演艺，羊肉怎么做？	cookbook@query	o o o o b-ingredient i-ingredient o o o o
炸馒头片	cookbook@query	b-dishname i-dishname i-dishname i-dishname
有什么特色美食。	cookbook@query	o o o b-keyword i-keyword i-keyword i-keyword o
恒宇乐活鱼怎么做的好吃的回复哦，你。	cookbook@query	o o o b-ingredient i-ingredient o o o o o o o o o o o o o
酸菜鱼的做法，妈。	cookbook@query	b-dishname i-dishname i-dishname o o o o o o
烤鸭，啊！	cookbook@query	b-dishname i-dishname o o o
怎么煮面才好吃呢？	cookbook@query	o o b-dishname i-dishname o o o o o
酸辣汤的做法。	cookbook@query	b-dishname i-dishname i-dishname o o o o
做蛋挞怎么做	cookbook@query	o b-dishname i-dishname o o o
那做红烧鱼需要哪些材料啊？	cookbook@query	o o b-dishname i-dishname i-dishname o o o o o o o o
鱼肉怎么做？	cookbook@query	b-ingredient i-ingredient o o o o
帮我查一下红烧肉的做法	cookbook@query	o o o o o b-dishname i-dishname i-dishname o o o
冰糖雪梨	cookbook@query	b-dishname i-dishname i-dishname i-dishname
红薯粉的做法，了。	cookbook@query	b-ingredient i-ingredient i-ingredient o o o o o o
红豆沙怎么做？	cookbook@query	b-dishname i-dishname i-dishname o o o o
红烧鱼块。	cookbook@query	b-dishname i-dishname i-dishname i-dishname o
煮面怎么做？	cookbook@query	b-dishname i-dishname o o o o
花格等蛋的做法。	cookbook@query	o o o b-ingredient o o o o
怎样蒸排骨最好吃的。	cookbook@query	o o b-dishname i-dishname i-dishname o o o o o
红烧肉怎么做？嗯？	cookbook@query	b-dishname i-dishname i-dishname o o o o o o
狗肉怎么做？	cookbook@query	b-ingredient i-ingredient o o o o
甜酒怎么做？	cookbook@query	b-ingredient i-ingredient o o o o
你给我讲讲红烧肉的做法。	cookbook@query	o o o o o b-dishname i-dishname i-dishname o o o o
a排骨怎么做好吃？	cookbook@query	o b-ingredient i-ingredient o o o o o o
紫菜蛋花汤。	cookbook@query	b-dishname i-dishname i-dishname i-dishname i-dishname o
求米线怎么做？	cookbook@query	o b-ingredient i-ingredient o o o o
红烧肉的做法，a。	cookbook@query	b-dishname i-dishname i-dishname o o o o o o
青椒肉丝怎么做怎么炒？	cookbook@query	b-dishname i-dishname i-dishname i-dishname o o o o o o o
怎么做饭好吃？	cookbook@query	o o o b-dishname o o o
椒盐排骨怎么做？你？	cookbook@query	b-dishname i-dishname i-dishname i-dishname o o o o o o
鱼香肉丝哦	cookbook@query	b-dishname i-dishname i-dishname i-dishname o
帮我转发邮件	email@forward	o o o o o o
发邮件给莹莹说我好困我想睡觉	email@send	o o o o b-name i-name o b-content i-content i-content i-content i-content i-content i-content
我想全部回应	email@replay_all	o o o o o o
帮我写个邮件	email@create	o o o o o o
我想要转发这封邮件	email@forward	o o o o o o o o o
我要写条新邮件	email@create	o o o o o o o
我要查看邮件	email@launch	o o o o o o
替我查看新邮件	email@launch	o o o o o o o
帮我写一封邮件	email@create	o o o o o o o
我想全部回复	email@replay_all	o o o o o o
全部应答	email@replay_all	o o o o
我要全部回复	email@replay_all	o o o o o o
我想要转发这条邮件	email@forward	o o o o o o o o o
发邮件给晶晶	email@send	o o o o b-name i-name
我想写一个新邮件	email@create	o o o o o o o o
我想答复这个邮件	email@reply	o o o o o o o o
替我打开新邮件	email@launch	o o o o o o o
帮我写一条新邮件	email@create	o o o o o o o o
给我写一个新邮件	email@create	o o o o o o o o
给我打开mail	email@launch	o o o o o o o o
中央一套什么时候有建党伟业	epg@query	b-tvchannel i-tvchannel i-tvchannel i-tvchannel o o o o o b-name i-name i-name i-name
湖南卫视放什么节目？	epg@query	b-tvchannel i-tvchannel i-tvchannel i-tvchannel o o o o o o
周二电影。	cinemas@query	b-datetime_date i-datetime_date o o o
我要看湖南卫视快乐大本营	epg@query	o o o b-tvchannel i-tvchannel i-tvchannel i-tvchannel b-name i-name i-name i-name i-name
看当前直播的比赛	epg@query	o o o o o o b-category i-category
现在电视台在放什么节目	epg@query	b-datetime_time i-datetime_time o o o o o o o b-category i-category
查查最近一周cctv-4美洲有放我爱记歌词么	epg@query	o o b-datetime_date i-datetime_date i-datetime_date i-datetime_date b-tvchannel i-tvchannel i-tvchannel i-tvchannel i-tvchannel i-tvchannel i-tvchannel i-tvchannel o o b-name i-name i-name i-name i-name o
湖南卫视娱乐节目。	epg@query	b-tvchannel i-tvchannel i-tvchannel i-tvchannel b-category i-category o o o
湖南台演什么节目	epg@query	b-tvchannel i-tvchannel i-tvchannel o o o o o
今天湖南卫视的电子节目单	epg@query	b-datetime_date i-datetime_date b-tvchannel i-tvchannel i-tvchannel i-tvchannel o o o o o o
非诚勿扰什么时候演啊	epg@query	b-name i-name i-name i-name o o o o o o
我想看中央六台的电影。	epg@query	o o o b-tvchannel i-tvchannel i-tvchannel i-tvchannel o b-category i-category o
中央四频道火箭兜风	epg@query	b-tvchannel i-tvchannel i-tvchannel i-tvchannel i-tvchannel b-name i-name i-name i-name
央视少儿频道的节目的	epg@query	b-tvchannel i-tvchannel i-tvchannel i-tvchannel i-tvchannel i-tvchannel o o o o
你，湖南卫视正在播出什么？你。	epg@query	o o b-tvchannel i-tvchannel i-tvchannel i-tvchannel o o o o o o o o o
现在湖南卫视放什么电视？	epg@query	b-datetime_time i-datetime_time b-tvchannel i-tvchannel i-tvchannel i-tvchannel o o o o o o
搜索电视剧爱情悠悠药草香在哪个频道首播？	epg@query	o o b-category i-category i-category b-name i-name i-name i-name i-name i-name i-name o o o o o o o o
看看今天有什么好看的节目？	epg@query	o o b-datetime_date i-datetime_date o o o o o o b-category i-category o
爱笑会议室什么时候播放	epg@query	b-name i-name i-name i-name i-name o o o o o o
安徽卫视今天晚上放什么？	epg@query	b-tvchannel i-tvchannel i-tvchannel i-tvchannel b-datetime_date i-datetime_date b-datetime_time i-datetime_time o o o o
回看烽火佳人回看安徽卫视烽火佳人	epg@look_back	o o b-name i-name i-name i-name o o b-tvchannel i-tvchannel i-tvchannel i-tvchannel o o o o
现在最好看的电影。	cinemas@query	b-datetime_date i-datetime_date o o o o o o o
帮我查找一下今天晚上有什么电视节目？	epg@query	o o o o o o b-datetime_date i-datetime_date b-datetime_time i-datetime_time o o o o o b-category i-category o
咱们结婚吧什么时候播出	cinemas@date_query	b-name i-name i-name i-name i-name o o o o o o
焦点访谈什么时候播	epg@query	b-name i-name i-name i-name o o o o o
安安昨天11:07的风华国乐	epg@query	o o b-datetime_date i-datetime_date b-datetime_time i-datetime_time i-datetime_time i-datetime_time i-datetime_time o b-tvchannel i-tvchannel i-tvchannel i-tvchannel
北京体育频道明天的节目单	epg@query	b-tvchannel i-tvchannel i-tvchannel i-tvchannel i-tvchannel i-tvchannel b-datetime_date i-datetime_date o o o o
昨天的北京新闻	news@play	b-datetime_date i-datetime_date o b-location_city i-location_city o o
东方高清台的节目单	epg@query	b-tvchannel i-tvchannel i-tvchannel i-tvchannel i-tvchannel o o o o
哪个电视台在放神雕侠侣。	epg@query	o o o o o o o b-name i-name i-name i-name o
上海东方卫视现在在播放什么？	epg@query	b-tvchannel i-tvchannel i-tvchannel i-tvchannel i-tvchannel i-tvchannel b-datetime_time i-datetime_time o o o o o o
国防军事频道2天后播捍卫者	epg@query	b-tvchannel i-tvchannel i-tvchannel i-tvchannel o o b-datetime_date i-datetime_date i-datetime_date o b-name i-name i-name
电影频道明天放什么	epg@query	b-tvchannel i-tvchannel i-tvchannel i-tvchannel b-datetime_date i-datetime_date o o o
湖南卫视明天播什么节目	epg@query	b-tvchannel i-tvchannel i-tvchannel i-tvchannel b-datetime_date i-datetime_date o o o o o
少儿节目中央少儿节目	epg@query	b-category i-category o o b-tvchannel i-tvchannel i-tvchannel i-tvchannel i-tvchannel i-tvchannel
北京卡酷熊出没	epg@query	b-tvchannel i-tvchannel i-tvchannel i-tvchannel b-name i-name i-name
cctv-10的百家讲坛	epg@query	b-tvchannel i-tvchannel i-tvchannel i-tvchannel i-tvchannel i-tvchannel i-tvchannel o b-name i-name i-name i-name
哪个频道演爸爸去哪儿	epg@query	o o o o o b-name i-name i-name i-name i-name
哪个电视台在演叶问。	epg@query	o o o o o o o b-name i-name o
蒽蒽江苏卫视有什么好节目吗？	epg@query	o o b-tvchannel i-tvchannel i-tvchannel i-tvchannel o o o o o o o o
上周六发现之旅有演星跳水立方呢	epg@query	o o o b-tvchannel i-tvchannel i-tvchannel i-tvchannel o b-name i-name i-name i-name i-name i-name o
安徽电视台12月18号晚上10:10的电视剧	epg@query	b-tvchannel i-tvchannel i-tvchannel i-tvchannel i-tvchannel o b-datetime_date i-datetime_date i-datetime_date i-datetime_date i-datetime_date b-datetime_time i-datetime_time i-datetime_time i-datetime_time i-datetime_time i-datetime_time i-datetime_time o o o o
看中央七频道讲武堂节目	epg@query	o b-tvchannel i-tvchannel i-tvchannel i-tvchannel i-tvchannel b-name i-name i-name o o
现在哪个频道播放电视剧	epg@query	b-datetime_time i-datetime_time o o o o o o b-category i-category i-category
现在有什么好看的电视剧？	video@query	o o o o o b-scoredescr i-scoredescr o b-category i-category i-category o
熊出没是几点开始播放。	epg@query	b-name i-name i-name o o o o o o o o
哪些台在放电影	epg@query	o o o o o b-category i-category
影视频道有什么节目	epg@query	b-tvchannel i-tvchannel i-tvchannel i-tvchannel o o o o o
书画频道上周六有开始非诚勿扰么	epg@query	b-tvchannel i-tvchannel i-tvchannel i-tvchannel b-datetime_date i-datetime_date i-datetime_date o o o b-name i-name i-name i-name o
可不中央五套明天的节目单	epg@query	o o b-tvchannel i-tvchannel i-tvchannel i-tvchannel b-datetime_date i-datetime_date o o o o
河南卫视节目单。	epg@query	b-tvchannel i-tvchannel i-tvchannel i-tvchannel o o o o
现在电视台在播什么	epg@query	b-datetime_time i-datetime_time o o o o o o o
现在有什么好的电视剧。	epg@query	b-datetime_time i-datetime_time o o o o o b-category i-category i-category o
那中央六台明天演什么节目	epg@query	o b-tvchannel i-tvchannel i-tvchannel i-tvchannel b-datetime_date i-datetime_date o o o o o
央视三台现在播放什么节目	epg@query	b-tvchannel i-tvchannel i-tvchannel i-tvchannel b-datetime_time i-datetime_time o o o o o o
现在中央一台在播什么节目？	epg@query	b-datetime_time i-datetime_time b-tvchannel i-tvchannel i-tvchannel i-tvchannel o o o o o o o
回看安徽卫视烽火佳人	epg@look_back	o o b-tvchannel i-tvchannel i-tvchannel i-tvchannel b-name i-name i-name i-name
给我搜搜什么电视台什么时间有转播神探高伦布	epg@query	o o o o o o o o o o o o o o o o b-name i-name i-name i-name i-name
我回去看昨天晚上播出的爸爸去哪儿31频道	epg@query	o o o o b-datetime_date i-datetime_date b-datetime_time i-datetime_time o o o b-name i-name i-name i-name i-name b-code i-code o o
查查什么时候放百变大咖秀	epg@query	o o o o o o o b-name i-name i-name i-name i-name
8点河北卫视播放过恋了爱了	epg@query	b-datetime_time i-datetime_time b-tvchannel i-tvchannel i-tvchannel i-tvchannel o o o b-name i-name i-name i-name
中央六台有什么节目	epg@query	b-tvchannel i-tvchannel i-tvchannel i-tvchannel o o o o o
今天什么好看电影？	epg@query	b-datetime_date i-datetime_date o o o o b-category i-category o
btv北京频道打狗棍	epg@query	b-tvchannel i-tvchannel i-tvchannel i-tvchannel i-tvchannel i-tvchannel i-tvchannel b-name i-name i-name
搜一下cctv74月15号播出新编辑部的故事呢	epg@query	o o o b-tvchannel i-tvchannel i-tvchannel i-tvchannel i-tvchannel b-datetime_date i-datetime_date i-datetime_date i-datetime_date i-datetime_date o o b-name i-name i-name i-name i-name i-name i-name o
什么时候有西游记呢？	epg@query	o o o o o b-name i-name i-name o o
快乐大本营什么时间播？	epg@query	b-name i-name i-name i-name i-name o o o o o o
明天晚上湖南卫视演什么电视剧	epg@query	b-datetime_date i-datetime_date b-datetime_time i-datetime_time b-tvchannel i-tvchannel i-tvchannel i-tvchannel o o o b-category i-category i-category
我昨天晚上的今日关注	epg@query	o b-datetime_date i-datetime_date b-datetime_time i-datetime_time o b-name i-name i-name i-name
北京台有什么好电视	epg@query	b-tvchannel i-tvchannel i-tvchannel o o o o o o
回看上周末早上8点的湖南卫视	epg@look_back	o o b-datetime_date i-datetime_date i-datetime_date b-datetime_time i-datetime_time i-datetime_time i-datetime_time o b-tvchannel i-tvchannel i-tvchannel i-tvchannel
济南到重庆的航班。	flight@query	b-startloc_city i-startloc_city o b-endloc_city i-endloc_city o o o o
厦门到上海的机票	flight@query	b-startloc_city i-startloc_city o b-endloc_city i-endloc_city o o o
查询一下明天广州到武汉的航班	flight@query	o o o o b-startdate_date i-startdate_date b-startloc_city i-startloc_city o b-endloc_city i-endloc_city o o o
帮我订一张杭州到上海的机票	flight@query	o o o o o b-startloc_city i-startloc_city o b-endloc_city i-endloc_city o o o
八月十号从重庆到武汉的航班	flight@query	b-startdate_date i-startdate_date i-startdate_date i-startdate_date o b-startloc_city i-startloc_city o b-endloc_city i-endloc_city o o o
济南到汉中的飞机票	flight@query	b-startloc_city i-startloc_city o b-endloc_city i-endloc_city o o o o
儋州到海口的航班	flight@query	b-startloc_area i-startloc_area o b-endloc_city i-endloc_city o o o
查询厦门到武夷山的航班	flight@query	o o b-startloc_city i-startloc_city o b-endloc_area i-endloc_area i-endloc_area o o o
查一下从南京到上海的航班	flight@query	o o o o b-startloc_city i-startloc_city o b-endloc_city i-endloc_city o o o
查询今天成都到北京的航班	flight@query	o o b-startdate_date i-startdate_date b-startloc_city i-startloc_city o b-endloc_city i-endloc_city o o o
南昌到广州飞机票	flight@query	b-startloc_city i-startloc_city o b-endloc_city i-endloc_city o o o
明天去桂林的航班。	flight@query	b-startdate_date i-startdate_date o b-endloc_city i-endloc_city o o o o
7月30号去深圳的航班。	flight@query	b-startdate_date i-startdate_date i-startdate_date i-startdate_date i-startdate_date o b-endloc_city i-endloc_city o o o o
南京到成都的机票	flight@query	b-startloc_city i-startloc_city o b-endloc_city i-endloc_city o o o
明天去南昌的航班。	flight@query	b-startdate_date i-startdate_date o b-endloc_city i-endloc_city o o o o
查一下明天合肥到北京的航班。	flight@query	o o o b-startdate_date i-startdate_date b-startloc_city i-startloc_city o b-endloc_city i-endloc_city o o o o
7月25号去上海的航班。	flight@query	b-startdate_date i-startdate_date i-startdate_date i-startdate_date i-startdate_date o b-endloc_city i-endloc_city o o o o
明天长沙到上海的航班	flight@query	b-startdate_date i-startdate_date b-startloc_city i-startloc_city o b-endloc_city i-endloc_city o o o
从威海到苏州的飞机	flight@query	o b-startloc_city i-startloc_city o b-endloc_city i-endloc_city o o o
给我定一张株洲到深圳的机票	flight@query	o o o o o b-startloc_city i-startloc_city o b-endloc_city i-endloc_city o o o
搜索武汉到南京的机票	flight@query	o o b-startloc_city i-startloc_city o b-endloc_city i-endloc_city o o o
上海飞往北京的航班	flight@query	b-startloc_city i-startloc_city o o b-endloc_city i-endloc_city o o o
查一下澳门到吉隆坡的飞机	flight@query	o o o b-startloc_city i-startloc_city o b-endloc_city i-endloc_city i-endloc_city o o o
后天去武汉的航班	flight@query	b-startdate_date i-startdate_date o b-endloc_city i-endloc_city o o o
查询4月1号从武汉到广州的航班	flight@query	o o b-startdate_date i-startdate_date i-startdate_date i-startdate_date o b-startloc_city i-startloc_city o b-endloc_city i-endloc_city o o o
上海到青岛的飞机票	flight@query	b-startloc_city i-startloc_city o b-endloc_city i-endloc_city o o o o
帮我查一下广州到长沙的航班	flight@query	o o o o o b-startloc_city i-startloc_city o b-endloc_city i-endloc_city o o o
明天去深圳的飞机	flight@query	b-startdate_date i-startdate_date o b-endloc_city i-endloc_city o o o
贵阳到哈尔滨飞机	flight@query	b-startloc_city i-startloc_city o b-endloc_city i-endloc_city i-endloc_city o o
去伦敦的航班	flight@query	o b-endloc_city i-endloc_city o o o
晋江到武汉的航班	flight@query	b-startloc_area i-startloc_area o b-endloc_city i-endloc_city o o o
四月二十日合肥到深圳的航班	flight@query	b-startdate_date i-startdate_date i-startdate_date i-startdate_date i-startdate_date b-startloc_city i-startloc_city o b-endloc_city i-endloc_city o o o
查询上海到玉林的航班。	flight@query	o o b-startloc_city i-startloc_city o b-endloc_city i-endloc_city o o o o
从厦门到昆明的飞机	flight@query	o b-startloc_city i-startloc_city o b-endloc_city i-endloc_city o o o
到北京的飞机。	flight@query	o b-endloc_city i-endloc_city o o o o
帮我查一下深圳到桂林后天的机票	flight@query	o o o o o b-startloc_city i-startloc_city o b-endloc_city i-endloc_city b-startdate_date i-startdate_date o o o
查一下明天晚上17点30分从上海飞往珠海三灶机场的飞机	flight@query	o o o b-startdate_date i-startdate_date o b-startloc_city i-startloc_city i-startdate_time i-startdate_time i-startdate_time i-startdate_time i-startdate_time o o o o o b-endloc_city i-endloc_city b-endloc_poi i-endloc_poi i-endloc_poi i-endloc_poi o o o
帮我查一下明天广州到北京的航班。	flight@query	o o o o o b-startdate_date i-startdate_date b-startloc_city i-startloc_city o b-endloc_city i-endloc_city o o o o
八月十一日从厦门飞往上海的航班	flight@query	b-startdate_date i-startdate_date i-startdate_date i-startdate_date i-startdate_date o b-startloc_city i-startloc_city o o b-endloc_city i-endloc_city o o o
查一下济南到成都的航班	flight@query	o o o b-startloc_city i-startloc_city o b-endloc_city i-endloc_city o o o
帮我查一下明天南昌到广州的飞机票	flight@query	o o o o o b-startdate_date i-startdate_date b-startloc_city i-startloc_city o b-endloc_city i-endloc_city o o o o
查询广州到海南的航班	flight@query	o o b-startloc_city i-startloc_city o b-endloc_city i-endloc_city o o o
查询明天南阳到上海的航班	flight@query	o o b-startdate_date i-startdate_date b-startloc_city i-startloc_city o b-endloc_city i-endloc_city o o o
八月一号去上海的航班	flight@query	b-startdate_date i-startdate_date i-startdate_date i-startdate_date o b-endloc_city i-endloc_city o o o
明天温州到上海的航班。	flight@query	b-startdate_date i-startdate_date b-startloc_city i-startloc_city o b-endloc_city i-endloc_city o o o o
请查询一下深圳飞往上海的航班	flight@query	o o o o o b-startloc_city i-startloc_city o o b-endloc_city i-endloc_city o o o
宫外孕怎么办？	health@query	b-keyword i-keyword i-keyword o o o o
得了肝癌怎么办？	health@query	o o b-keyword i-keyword o o o o
发烧好吗？	health@query	b-keyword i-keyword o o o
咳嗽怎么治？	health@query	b-keyword i-keyword o o o o
给我查一下，乳腺增生怎么治疗？	health@query	o o o o o o b-keyword i-keyword i-keyword i-keyword o o o o o
。咳嗽	health@query	o b-keyword i-keyword
胃炎怎么治？	health@query	b-keyword i-keyword o o o o
肠易激综合征。	health@query	b-keyword i-keyword i-keyword i-keyword i-keyword i-keyword o
沙眼。	health@query	b-keyword i-keyword o
颈椎病用什么药物治疗？	health@query	b-keyword i-keyword i-keyword o o o o o o o o
甲型肝炎。	health@query	b-keyword i-keyword i-keyword i-keyword o
耳鸣怎么办	health@query	b-keyword i-keyword o o o
骨折了怎么办？	health@query	b-keyword i-keyword o o o o o
介绍一下尖锐湿疣	health@query	o o o o b-keyword i-keyword i-keyword i-keyword
甲亢怎么办？	health@query	b-keyword i-keyword o o o o
如何治疗颈椎病。	health@query	o o o o b-keyword i-keyword i-keyword o
包皮过长，怎么办？哦。	health@query	b-keyword i-keyword i-keyword i-keyword o o o o o o o
胆结石怎样治疗。	health@query	b-keyword i-keyword i-keyword o o o o o
胃溃疡。	health@query	b-keyword i-keyword i-keyword o
大肠癌	health@query	b-keyword i-keyword i-keyword
白带异常。	health@query	b-keyword i-keyword i-keyword i-keyword o
关节痛怎么办？	health@query	b-keyword i-keyword i-keyword o o o o
肾炎需要注意什么？	health@query	b-keyword i-keyword o o o o o o o
怎么治感冒？	health@query	o o o b-keyword i-keyword o
肾虚怎么治疗	health@query	b-keyword i-keyword o o o o
静脉曲张怎么治疗？哦？	health@query	b-keyword i-keyword i-keyword i-keyword o o o o o o o
类风湿怎么治？	health@query	b-keyword i-keyword i-keyword o o o o
发烧。	health@query	b-keyword i-keyword o
我是个女的，你知道怎样治脱发吗	health@query	o o o o o o o o o o o o b-keyword i-keyword o
得了艾滋病怎么办	health@query	o o b-keyword i-keyword i-keyword o o o
得了灰指甲怎么办？	health@query	o o b-keyword i-keyword i-keyword o o o o
前列腺炎该怎么治？	health@query	b-keyword i-keyword i-keyword i-keyword o o o o o
梅毒怎么治疗？	health@query	b-keyword i-keyword o o o o o
如何治疗龟头炎。	health@query	o o o o b-keyword i-keyword i-keyword o
怎么治疗口腔溃疡呃呃呃	health@query	o o o o b-keyword i-keyword i-keyword i-keyword o o o
肾积水怎么治？	health@query	b-keyword i-keyword i-keyword o o o o
湿疹怎么处理？	health@query	b-keyword i-keyword o o o o o
乳腺炎。	health@query	b-keyword i-keyword i-keyword o
尿道炎怎么办	health@query	b-keyword i-keyword i-keyword o o o
近视眼怎么治疗	health@query	b-keyword i-keyword i-keyword o o o o
头晕该怎么办？	health@query	b-keyword i-keyword o o o o o
肩周炎怎么治？	health@query	b-keyword i-keyword i-keyword o o o o
甲亢。	health@query	b-keyword i-keyword o
包茎怎么办？	health@query	b-keyword i-keyword o o o o
截瘫吧	health@query	b-keyword i-keyword o
淋病怎么办	health@query	b-keyword i-keyword o o o
肩周炎，要怎么治疗。	health@query	b-keyword i-keyword i-keyword o o o o o o o
我要买彩票。	lottery@query	o o o o o o
搜索大乐透的中奖号码	lottery@number_query	o o b-name i-name i-name o o o o o
帮我查一下2013年2月8日开奖的15选5中奖号码	lottery@number_query	o o o o o b-datetime_date i-datetime_date b-name i-name i-name i-name i-datetime_date i-datetime_date i-datetime_date o o o o o o o o o o o
查七乐彩开奖结果	lottery@number_query	o b-name i-name i-name o o o o
提供一张大乐透	lottery@number_query	o o o o b-name i-name i-name
查看七乐彩的得奖号码	lottery@number_query	o o b-name i-name i-name o o o o o
上一期双色球开什么	lottery@number_query	b-relissue i-relissue i-relissue b-name i-name i-name o o o
大乐透中奖号码为	lottery@number_query	b-name i-name i-name o o o o o
我要查彩票的开奖信息。	lottery@number_query	o o o o o o o o o o o
看一看大乐透的信息	lottery@number_query	o o o b-name i-name i-name o o o
本期七星彩的中奖号码是多少？	lottery@number_query	o o b-name i-name i-name o o o o o o o o o
搜索15选5的号码信息	lottery@number_query	o o b-name i-name i-name i-name o o o o o
七星彩	lottery@number_query	b-name i-name i-name
搜索七乐彩的公示号码	lottery@number_query	o o b-name i-name i-name o o o o o
我要购买七乐彩	lottery@number_query	o o o o b-name i-name i-name
帮我查一下上一期的大乐透	lottery@number_query	o o o o o b-relissue i-relissue i-relissue o b-name i-name i-name
大乐透的开奖情况	lottery@number_query	b-name i-name i-name o o o o o
到太湖怎么走	map@route	o b-endloc_area i-endloc_area o o o
去常州武进路线	map@route	o b-endloc_city i-endloc_city b-endloc_area i-endloc_area o o
湖里公园在哪里	map@position	b-location_poi i-location_poi i-location_poi i-location_poi o o o
带我去丹阳市眼镜市场	map@route	o o o b-endloc_area i-endloc_area o b-endloc_poi i-endloc_poi i-endloc_poi i-endloc_poi
上海到苏州	map@route	b-startloc_city i-startloc_city o b-endloc_city i-endloc_city
美国大使馆在哪	map@position	b-location_poi i-location_poi i-location_poi i-location_poi i-location_poi o o
去科大讯飞怎么走	map@route	o b-endloc_poi i-endloc_poi i-endloc_poi i-endloc_poi o o o
松江钢材城在哪里	map@position	b-location_poi i-location_poi i-location_poi i-location_poi i-location_poi o o o
我想到科大讯飞怎么走	map@route	o o o b-endloc_poi i-endloc_poi i-endloc_poi i-endloc_poi o o o
去湘江	map@route	o b-endloc_poi i-endloc_poi
合肥百货大楼在哪里	map@position	b-location_city i-location_city b-location_poi i-location_poi i-location_poi i-location_poi o o o
往火车北站怎么走	map@route	o b-endloc_poi i-endloc_poi i-endloc_poi i-endloc_poi o o o
辽宁大连在哪里	map@position	b-location_province i-location_province b-location_city i-location_city o o o
到步行街不走高架的路线是哪条	map@route	o b-endloc_poi i-endloc_poi i-endloc_poi o o o o o o o o o o
到鼓楼怎么走	map@route	o b-endloc_area i-endloc_area o o o
合肥的大润发在哪	map@position	b-location_city i-location_city o b-location_poi i-location_poi i-location_poi o o
怎么去泉城广场	map@route	o o o b-endloc_poi i-endloc_poi i-endloc_poi i-endloc_poi
到合肥市逍遥津公园怎么走	map@route	o b-endloc_city i-endloc_city o b-endloc_poi i-endloc_poi i-endloc_poi i-endloc_poi i-endloc_poi o o o
沿途有没有加油站	map@position	o o o o o b-location_poi i-location_poi i-location_poi
到环都大酒店怎么走	map@route	o b-endloc_poi i-endloc_poi i-endloc_poi i-endloc_poi i-endloc_poi o o o
到公园怎么走	map@route	o b-endloc_poi i-endloc_poi o o o
我要去姜堰	map@route	o o o b-endloc_area i-endloc_area
六安市飞云卫生院在哪里	map@position	b-location_city i-location_city i-location_city b-location_poi i-location_poi i-location_poi i-location_poi i-location_poi o o o
从这里到市中心怎么走	map@route	o o o o b-endloc_poi i-endloc_poi i-endloc_poi o o o
查询北京到上海的路线	map@route	o o b-startloc_city i-startloc_city o b-endloc_city i-endloc_city o o o
讯飞语点我现在在哪里	map@position	o o o o o o o o o o
春熙路怎么走	map@route	b-endloc_poi i-endloc_poi i-endloc_poi o o o
怎么去龙阳路	map@route	o o o b-endloc_poi i-endloc_poi i-endloc_poi
到郑州火车站	map@route	o b-endloc_city i-endloc_city b-endloc_poi i-endloc_poi i-endloc_poi
宁波机场在哪里	map@position	b-location_city i-location_city b-location_poi i-location_poi o o o
从二手车市场到八一广场怎么走	map@route	o b-startloc_poi i-startloc_poi i-startloc_poi i-startloc_poi i-startloc_poi o b-endloc_poi i-endloc_poi i-endloc_poi i-endloc_poi o o o
帮我查一下合肥市三孝口在哪里	map@position	o o o o o b-location_city i-location_city o b-location_poi i-location_poi i-location_poi o o o
帮我搜一下科大讯飞在哪	map@position	o o o o o b-location_poi i-location_poi i-location_poi i-location_poi o o
查询沿途的ktv	map@position	o o o o o b-location_poi i-location_poi i-location_poi
鹰潭到景德镇	map@route	b-startloc_city i-startloc_city o b-endloc_city i-endloc_city i-endloc_city
从我这里到科大讯飞走高速路线	map@route	o o o o o b-endloc_poi i-endloc_poi i-endloc_poi i-endloc_poi o o o o o
南京火车站到南京农业大学	map@route	b-startloc_city i-startloc_city b-startloc_poi i-startloc_poi i-startloc_poi i-endloc_poi o o o o o o
告诉我西安的位置	map@position	o o o b-location_city i-location_city o o o
去汽车南站怎么走	map@route	o b-endloc_poi i-endloc_poi i-endloc_poi i-endloc_poi o o o
我们现在在什么地方	map@position	o o o o o o o o o
从我这里去芙蓉区政府怎么去	map@route	o o o o o b-endloc_poi i-endloc_poi i-endloc_poi i-endloc_poi i-endloc_poi o o o
南光集团怎么走	map@route	b-endloc_poi i-endloc_poi i-endloc_poi i-endloc_poi o o o
导航到山东省菏泽市王浩屯镇	map@route	o o o b-endloc_province i-endloc_province i-endloc_province b-endloc_city i-endloc_city i-endloc_city b-endloc_area i-endloc_area i-endloc_area i-endloc_area
昆山大润发在哪里	map@position	b-location_area i-location_area b-location_poi i-location_poi i-location_poi o o o
帮我找到去安徽黄山的路	map@route	o o o o o b-endloc_province i-endloc_province b-endloc_poi i-endloc_poi o o
从新加坡花园怎么去宁溪路	map@route	o b-startloc_poi i-startloc_poi i-startloc_poi i-startloc_poi i-startloc_poi o o o b-endloc_poi i-endloc_poi i-endloc_poi
从观音桥到重庆市图书馆怎么走	map@route	o b-startloc_poi i-startloc_poi i-startloc_poi o b-endloc_poi i-endloc_poi i-endloc_poi i-endloc_poi i-endloc_poi i-endloc_poi o o o
导航到建八路	map@route	o o o b-endloc_poi i-endloc_poi i-endloc_poi
平阳怎么走吗	map@route	b-endloc_area i-endloc_area o o o o
移动公司在哪里呀	map@position	b-location_poi i-location_poi i-location_poi i-location_poi o o o o
湘潭到常德怎么走	map@route	b-startloc_city i-startloc_city o b-endloc_city i-endloc_city o o o
从连云港到北京该怎么走	map@route	o b-startloc_city i-startloc_city i-startloc_city o b-endloc_city i-endloc_city o o o o
宁乡到长沙怎么走	map@route	b-startloc_area i-startloc_area o b-endloc_city i-endloc_city o o o
带我去新都会	map@route	o o o b-endloc_poi i-endloc_poi i-endloc_poi
导航去科大讯飞	map@route	o o o b-endloc_poi i-endloc_poi i-endloc_poi i-endloc_poi
7月13号广州恒大俱乐部的比赛有哪些	match@query	b-datetime_date i-datetime_date i-datetime_date i-datetime_date i-datetime_date b-name i-name i-name i-name o o o o o o o o o
北京国安的赛程。	match@query	b-name i-name i-name i-name o o o o
播放，青岛中能的赛程。	match@query	o o o b-name i-name i-name i-name o o o o
中超比赛时间多少啊？	match@query	b-category i-category o o o o o o o o
我要听中超第二十，八轮的结果。	match@query	o o o b-category i-category o o o o o o o o o o
江苏舜天队这个星期的比赛时间给我找出来	match@query	b-name i-name i-name i-name o b-datetime_date i-datetime_date i-datetime_date i-datetime_date o o o o o o o o o o
北京国安5月23号比赛和谁踢	match@query	b-name i-name i-name i-name b-datetime_date i-datetime_date i-datetime_date i-datetime_date i-datetime_date o o o o o
2013年中国男足，主要赛程。	match@query	b-datetime_date i-datetime_date i-datetime_date i-datetime_date i-datetime_date b-category i-category i-category i-category o o o o o o
查询中超赛事。	match@query	o o b-category i-category o o o
哦，中超比赛时间三比五。	match@query	o o b-category i-category o o o o o o o o
中超比赛时间，我。	match@query	b-category i-category o o o o o o o
我想看足球中超，第25轮的比赛时间。	match@query	o o o o o b-category i-category o o o o o o o o o o o
上海申花的赛程。	match@query	b-name i-name i-name i-name o o o o
广州恒大亚冠联赛，比赛时间。	match@query	b-name i-name i-name i-name b-category i-category i-category i-category o o o o o o
中超赛事预告吗？	match@query	b-category i-category o o o o o o
广州恒大的赛程。	match@query	b-name i-name i-name i-name o o o o
中超a组比赛结果分别是多少	match@query	b-category i-category o o o o b-type i-type o o o o o
恒大山东鲁能比分是多少？	match@query	b-homename i-homename b-awayname i-awayname i-awayname i-awayname o o o o o o
国足最新赛程。	match@query	b-category i-category o o o o o
发信息给盛吉	message@send	o o o o b-name i-name
给许浩发一条短信	message@send	o b-name i-name o o o o o
发短信给叶少云晚上要不要出去玩	message@send	o o o o b-name i-name i-name b-content i-content i-content i-content i-content i-content i-content i-content
给张大萍发短信	message@send	o b-name i-name i-name o o o
发短信	message@send	o o o
发信息给老妈说我在吃饭	message@send	o o o o b-name i-name o b-content i-content i-content i-content
给刘三发短信说我今天没有空	message@send	o b-name i-name o o o o b-content i-content i-content i-content i-content i-content
发送短信给东莞李月华就说今天赶紧回来	message@send	o o o o o b-name i-name i-name i-name i-name o o b-content i-content i-content i-content i-content i-content
给晓琴发短信你在干吗	message@send	o b-name i-name o o o b-content i-content i-content i-content
给庄小雷发短信	message@send	o b-name i-name i-name o o o
给于海洋发短信	message@send	o b-name i-name i-name o o o
给张金波发短消息今天中午一起吃饭	message@send	o b-name i-name i-name o o o o b-content i-content i-content i-content i-content i-content i-content i-content
发信息给陈明哲	message@send	o o o o b-name i-name i-name
给丹丹发信息我一会儿就回来别等我了	message@send	o b-name i-name o o o b-content i-content i-content i-content i-content i-content i-content i-content i-content i-content i-content
给张倩倩发短信	message@send	o b-name i-name i-name o o o
发短信给张三我明天去北京	message@send	o o o o b-name i-name b-content i-content i-content i-content i-content i-content
给靖哥哥发短信说我不回来吃饭了	message@send	o b-name i-name i-name o o o o b-content i-content i-content i-content i-content i-content i-content
发短信给啊妈说车票买到了	message@send	o o o o b-name i-name o b-content i-content i-content i-content i-content
发短信给姐姐说晚上一起吃面条	message@send	o o o o b-name i-name o b-content i-content i-content i-content i-content i-content i-content
给刘西发短信	message@send	o b-name i-name o o o
给梁辉坚发短信	message@send	o b-name i-name i-name o o o
给何建琴发短信	message@send	o b-name i-name i-name o o o
给马翊桐发信息	message@send	o b-name i-name i-name o o o
给原波发短信	message@send	o b-name i-name o o o
把王建春的电话号码发给张学政	message@sendcontacts	o b-name i-name i-name o o o o o o o b-receiver i-receiver i-receiver
发短信给王亮说死人你在干什么呢	message@send	o o o o b-name i-name o b-content i-content i-content i-content i-content i-content i-content i-content
给黄杠发短信	message@send	o b-name i-name o o o
给青发短信	message@send	o b-name o o o
发短信给王小露的	message@send	o o o o b-name i-name i-name o
发信息给学超	message@send	o o o o b-name i-name
呃发信息给周玉豪	message@send	o o o o o b-name i-name i-name
发信息给健美	message@send	o o o o b-name i-name
给王帅发个短信说他让他起来尿尿	message@send	o b-name i-name o o o o o o b-content i-content i-content i-content i-content i-content
给小阳发短信	message@send	o b-name i-name o o o
发条短信给张亚东	message@send	o o o o o b-name i-name i-name
给杨李鹏发短信	message@send	o b-name i-name i-name o o o
播放老婆最大。	music@play	o o b-song i-song i-song i-song o
随便唱几首歌吧	music@play	o o o o o o o
我想听歌曲传奇	music@play	o o o o o b-song i-song
帮我找一首我的好兄弟	music@search	o o o o o o o b-song i-song i-song
我想听老婆这首歌	music@play	o o o b-song i-song o o o
我想听想唱就唱	music@play	o b-song i-song i-song i-song o o
我想听情花开这首歌	music@play	o o o b-song i-song i-song o o o
我要听还是会这首歌	music@play	o o o b-song i-song i-song o o o
搜索歌曲公路	music@search	o o o o b-song i-song
播放黑猫警长。	music@play	o o b-song i-song i-song i-song o
来首只爱你一个。	music@play	o o b-song i-song i-song i-song i-song o
我想听水墨丹青这首歌	music@play	o o o b-song i-song i-song i-song o o o
我听首歌	music@play	o o o o
找一首游鸿明的音乐	music@search	o o o b-artist i-artist i-artist o o o
我想亲亲我的宝贝这首歌	music@play	o o b-song i-song i-song i-song i-song i-song o o o
我想听你最珍贵这首音乐	music@play	o o o b-song i-song i-song i-song o o o o
放一首音乐给我听	music@play	o o o o o o o o
我想听11年，这首歌哦。	music@play	o o o b-song i-song i-song o o o o o o
我要点一首小星星	music@play	o o o o o b-song i-song i-song
给我来首好听的音乐	music@play	o o o o b-category i-category o o o
放首陈奕迅的十年	music@play	o o b-artist i-artist i-artist o b-song i-song
放首歌给我听吧	music@play	o o o o o o o
我想听只对你有感觉	music@play	o o o b-song i-song i-song i-song i-song i-song
给我随便来几首歌	music@play	o o o o o o o o
我要听情动这首歌。	music@play	o o o b-song i-song o o o o
点播爱情买卖	music@play	o o b-song i-song i-song i-song
我想听世上只有妈妈好这首歌。	music@play	o o o b-song i-song i-song i-song i-song i-song i-song o o o o
我要听劝化这首歌	music@play	o o o b-song i-song o o o
随便给我放几首歌	music@play	o o o o o o o o
想听牵手这首歌	music@play	o o b-song i-song o o o
来首我的未来不是梦	music@play	o o b-song i-song i-song i-song i-song i-song i-song
我想听莫失莫忘。	music@play	o o o b-song i-song i-song i-song o
我想听伤感歌曲	music@play	o o o b-category i-category o o
来一首听你听我	music@play	o o o b-song i-song i-song i-song
唱一首两只蝴蝶。	music@play	o o o b-song i-song i-song i-song o
来一首夜夜夜	music@play	o o o b-song i-song i-song
给我放首歌	music@play	o o o o o
放首歌听一下你好	music@play	o o o o o o o o
来首快乐崇拜	music@play	o o b-song i-song i-song i-song
我想听忐忑这首歌打	music@play	o o o b-song i-song o o o o
播放田园的歌	music@play	o o b-artist i-artist o o
播放郁可唯的歌	music@play	o o b-artist i-artist i-artist o o
我想听音乐忘情水。	music@play	o o o o o b-song i-song i-song o
唱一首简单爱	music@play	o o o b-song i-song i-song
搜索电视剧插曲	music@search	o o b-category i-category i-category i-category i-category
喂喂那个我说想听音乐呢	music@play	o o o o o o o o o o o
王菲传奇。	music@play	b-artist i-artist b-song i-song o
来一首宝贝对不起	music@play	o o o b-song i-song i-song i-song i-song
搜索娱乐新闻。	news@play	o o b-category i-category o o o
美国最近有什么新闻	news@play	b-location_country i-location_country b-datetime_date i-datetime_date o o o o o
告诉我今天的新闻内容	news@play	o o o b-datetime_date i-datetime_date o o o o o
我看看现在的最新新闻是什么？	news@play	o o o b-datetime_time i-datetime_time o b-keyword i-keyword o o o o o o
零七播报新闻。	news@play	o o o o o o o
请问一下军事新闻。	news@play	o o o o b-category i-category o o o
龙岩新闻	news@play	b-location_city i-location_city o o
关于钓鱼岛的新闻进展	news@play	o o b-keyword i-keyword i-keyword o o o o o
答复，我要听新闻。	news@play	o o o o o o o o o
听新闻，姨。	news@play	o o o o o o
来个最新新闻。	news@play	o o b-keyword i-keyword o o o
最新的新闻播报一下	news@play	b-keyword i-keyword o o o o o o o
我想听，新闻。	news@play	o o o o o o o
我想听听今天的新闻。	news@play	o o o o b-datetime_date i-datetime_date o o o o
讲点新闻	news@play	o o o o
但我想点新闻。	news@play	o o o o o o o
今天杭州有什么新闻	news@play	b-datetime_date i-datetime_date b-location_city i-location_city o o o o o
看一下今天早上新闻。	news@play	o o o b-datetime_date i-datetime_date b-datetime_time i-datetime_time o o o
总计今天的新闻。	news@play	o o b-datetime_date i-datetime_date o o o o
今天有什么军事新闻	news@play	b-datetime_date i-datetime_date o o o b-category i-category o o
秦皇岛今天有什么新闻	news@play	b-location_city i-location_city i-location_city b-datetime_date i-datetime_date o o o o o
今天温州有什么新闻。	news@play	b-datetime_date i-datetime_date b-location_city i-location_city o o o o o o
我想听昨天晚上的新闻。	news@play	o o o b-datetime_date i-datetime_date b-datetime_time i-datetime_time o o o o
艾莱冈给我点新闻。	news@play	o o o o o o o o o
最近有什么热门新闻了。	news@play	b-datetime_date i-datetime_date o o o b-category i-category o o o o
姨，最近有什么新闻。	news@play	o o b-datetime_date i-datetime_date o o o o o o
播新闻，湖南新闻。	news@play	o o o o b-location_province i-location_province o o o
我想今天新闻最近有什么新的新闻？	news@play	o o b-datetime_date i-datetime_date o o o o o o o o o o o o
请给我讲一下今天的新闻吧！	news@play	o o o o o o b-datetime_date i-datetime_date o o o o o
我也听新闻。	news@play	o o o o o o
多想听新闻，哦。	news@play	o o o o o o o o
帮我搜索一下今天的新闻	news@play	o o o o o o b-datetime_date i-datetime_date o o o
看今天的新闻。	news@play	o b-datetime_date i-datetime_date o o o o
国际新闻。	news@play	b-category i-category o o o
我想听足球类新闻	news@play	o o o b-category i-category o o o
播放最近的新闻。	news@play	o o b-datetime_date i-datetime_date o o o o
今天有什么新闻呢。	news@play	b-datetime_date i-datetime_date o o o o o o o
讯飞语音我想知道山东省东营市今天的新闻。	news@play	o o o o o o o o b-location_province i-location_province i-location_province i-location_city o o b-datetime_date i-datetime_date o o o o
加，听新闻。	news@play	o o o o o o
搜索最新新闻	news@play	o o b-keyword i-keyword o o
听听新闻。	news@play	o o o o o
现在看看有最新的新闻吗？	news@play	b-datetime_time i-datetime_time o o o b-keyword i-keyword o o o o o
我要听新闻，给我数。	news@play	o o o o o o o o o o
噗我想听新闻。	news@play	o o o o o o o
今天东莞新闻。	news@play	b-datetime_date i-datetime_date b-location_city i-location_city o o o
搜索中国共产党章程	novel@query	o o b-name i-name i-name i-name i-name i-name i-name
可以找一下浪漫满屋的小说	novel@query	o o o o o b-name i-name i-name i-name o o o
查找校园小说沙漏第二部	novel@query	o o b-category i-category o o b-name i-name o o o
我要看魔幻学院小说	novel@query	o o o b-category i-category i-category i-category o o
我要看饶雪漫的小说左耳	novel@query	o o o b-author i-author i-author o o o b-name i-name
最近好看的小说	novel@query	o o b-popularity i-popularity o o o
搜索小说校园全能高手。	novel@query	o o o o b-name i-name i-name i-name i-name i-name o
给我讲个长篇小说。	novel@query	o o o o o o o o o
郭敬明的爱情小说《悲伤逆流成河》	novel@query	b-author i-author i-author o b-category i-category o o o b-name i-name i-name i-name i-name i-name o
我要看唐家三少写的玄幻小说绝世唐门	novel@query	o o o b-author i-author i-author i-author o o b-category i-category o o b-name i-name i-name i-name
我要看灵异推理小说	novel@query	o o o b-category i-category i-category i-category o o
我要看游戏异界小说	novel@query	o o o b-category i-category i-category i-category o o
你能搜到小说不？	novel@query	o o o o o o o o
我要看魔法神话小说	novel@query	o o o b-category i-category i-category i-category o o
网上最火的小说有哪些	novel@query	o o b-popularity i-popularity o o o o o o
我要看免费的小说。	novel@query	o o o o o o o o o
我要看古典仙侠小说	novel@query	o o o b-category i-category i-category i-category o o
我要看校园小说致我们终将逝去的青春	novel@query	o o o b-category i-category o o b-name i-name i-name i-name i-name i-name i-name i-name i-name i-name
玄幻小说 幻神	novel@query	b-category b-name i-name o o o o
我要看古言小说	novel@query	o o o b-category i-category o o
《武动乾坤》	video@query	o b-name i-name i-name i-name o
帮我找首诗。	poetry@default	o o o o o o
张，来首白居易的诗。	poetry@query	o o o o b-author i-author i-author o o o
给我背一首满江红。	poetry@query	o o o o o b-name i-name i-name o
你好啊，再背首诗。	poetry@default	o o o o o o o o o
来首宋词。	poetry@query	o o b-dynasty o o
搜索兰陵王。	poetry@query	o o b-name i-name i-name o
朗诵诗词。	poetry@default	o o o o o
请背诵静夜思。	poetry@query	o o o b-name i-name i-name o
古诗长恨歌。	poetry@query	o o b-name i-name i-name o
李白的诗词	poetry@query	b-author i-author o o o
那就来一首李白的诗词。	poetry@query	o o o o o b-author i-author o o o o
说一首唐诗吧！	poetry@query	o o o b-dynasty o o o
读一首古诗。	poetry@default	o o o o o o
你给我念一首李白的诗。	poetry@query	o o o o o o b-author i-author o o o
背将进酒。	poetry@query	o b-name i-name i-name o
背一下春晓孟浩然。	poetry@query	o o o b-name i-name b-author i-author i-author o
学而不厌，下一句是什么？	poetry@query	b-keyword i-keyword i-keyword i-keyword o b-queryfield i-queryfield i-queryfield o o o o
思春夜喜雨下一句是。	poetry@query	b-keyword i-keyword i-keyword i-keyword i-keyword b-queryfield i-queryfield i-queryfield o o
我想听首唐诗。	poetry@query	o o o o b-dynasty o o
朗读咏雪	poetry@query	o o b-name i-name
家，背首沁园春雪。	poetry@query	o o o o b-name i-name i-name i-name o
请念一首毛泽东诗词。	poetry@query	o o o o b-author i-author i-author o o o
背诵一首唐诗	poetry@query	o o o o b-dynasty o
来首李白的诗集。	poetry@query	o o b-author i-author o o o o
那你背首唐诗给我听。	poetry@query	o o o o b-dynasty o o o o o
仓央嘉措的诗词。	poetry@query	b-author i-author i-author i-author o o o o
您给我来一首，夏明翰的就义诗。	poetry@query	o o o o o o o b-author i-author i-author o b-name i-name i-name o
嗯，你来一首李白的诗词，的。	poetry@query	o o o o o o b-author i-author o o o o o o
说一句，白居易的诗。	poetry@query	o o o o b-author i-author i-author o o o
来首甘露寺。	poetry@query	o o b-name i-name i-name o
我要听宋词。	poetry@query	o o o b-dynasty o o
落花不是无情物的下一句是什么？	poetry@query	b-keyword i-keyword i-keyword i-keyword i-keyword i-keyword i-keyword o b-queryfield i-queryfield i-queryfield o o o o
雄关漫道真如铁下一句是什么？	poetry@query	b-keyword i-keyword i-keyword i-keyword i-keyword i-keyword i-keyword b-queryfield i-queryfield i-queryfield o o o o
李清照的诗。	poetry@query	b-author i-author i-author o o o
来一首纳兰性德的词。	poetry@query	o o o b-author i-author i-author i-author o o o
分手时，背一首诗吧？	poetry@default	o o o o o o o o o o
来一首白居易的长恨歌	poetry@query	o o o b-author i-author i-author o b-name i-name i-name
ok好，来首李白的诗词。	poetry@query	o o o o o o b-author i-author o o o o
李白的静夜思怎么读？	poetry@query	b-author i-author o b-name i-name i-name o o o o
来is，来一首采莲。	poetry@query	o o o o o o o b-name i-name o
蒋捷的宋词	poetry@query	b-author i-author o b-dynasty o
念个唐诗给我听。	poetry@query	o o b-dynasty o o o o o
唐寅的诗。	poetry@query	b-author i-author o o o
来一首唐诗吗？	poetry@query	o o o b-dynasty o o o
来一首，灵岩。	poetry@query	o o o o b-name i-name o
那你爸给我背一首唐诗了。	poetry@query	o o o o o o o o b-dynasty o o o
江山有奇峰，下一句。	poetry@query	b-keyword i-keyword i-keyword i-keyword i-keyword o b-queryfield i-queryfield i-queryfield o
长风吹月渡海来下一句是什么？	poetry@query	b-keyword i-keyword i-keyword i-keyword i-keyword i-keyword i-keyword b-queryfield i-queryfield i-queryfield o o o o
来一首李煜的词。	poetry@query	o o o b-author i-author o o o
呵呵，背首诗来听。	poetry@default	o o o o o o o o o
满园花菊郁金黄的下一句是什么？	poetry@query	b-keyword i-keyword i-keyword i-keyword i-keyword i-keyword i-keyword o b-queryfield i-queryfield i-queryfield o o o o
给我背个李白的诗。	poetry@query	o o o o b-author i-author o o o
再来背一首毛泽东的诗词。	poetry@query	o o o o o b-author i-author i-author o o o o
朗读游子吟。	poetry@query	o o b-name i-name i-name o
那就来一首李白的诗词吗？	poetry@query	o o o o o b-author i-author o o o o o
恶念首唐诗。	poetry@query	o o o b-dynasty o o
搜搜一首毛泽东的诗。	poetry@query	o o o o b-author i-author i-author o o o
杜甫的诗。	poetry@query	b-author i-author o o o
背一首春晓	poetry@query	o o o b-name i-name
背屈原的离骚	poetry@query	o b-author i-author o b-name i-name
背一首，纳兰容若的词。	poetry@query	o o o o b-author i-author i-author i-author o o o
查一首古诗，武林春。	poetry@query	o o o o o o b-name i-name i-name o
江涵秋影雁初飞的下一句是什么？	poetry@query	b-keyword i-keyword i-keyword i-keyword i-keyword i-keyword i-keyword o b-queryfield i-queryfield i-queryfield o o o o
我背一下春晓。	poetry@query	o o o o b-name i-name o
搜索古诗绝句。	poetry@query	o o o o b-name i-name o
我要听李白的诗。	poetry@query	o o o b-author i-author o o o
去网上搜索兰陵王。	poetry@query	o o o o o b-name i-name i-name o
给我来一首山歌吗？	poetry@query	o o o o o b-name i-name o o
来首唐诗小池	poetry@query	o o b-dynasty o b-name i-name
帮我来一首兰陵王。	poetry@query	o o o o o b-name i-name i-name o
月咏牡丹的下一句，是什么？	poetry@query	b-keyword i-keyword i-keyword i-keyword o b-queryfield i-queryfield i-queryfield o o o o o
那你给我背一首唐诗吧！	poetry@query	o o o o o o o b-dynasty o o o
背首绝句的。	poetry@query	o o b-name i-name o o
给我念首春晓。	poetry@query	o o o o b-name i-name o
李白的将进酒。	poetry@query	b-author i-author o b-name i-name i-name o
来首苏轼的词。	poetry@query	o o b-author i-author o o o
老朗诵首古诗。	poetry@default	o o o o o o o
念首诗听一下。	poetry@default	o o o o o o o
收听中国人民广播电台广播	radio@launch	o o b-name i-name i-name i-name i-name i-name i-name i-name i-name i-name
98.4香港电台第四台	radio@launch	b-code i-code i-code i-code b-name i-name i-name i-name i-name i-name i-name
请帮我调频89.7上虞人民广播电台	radio@launch	o o o o o b-code i-code i-code i-code b-name i-name i-name i-name i-name i-name i-name i-name
请帮我调频89.6武汉交通广播电台	radio@launch	o o o o o b-code i-code i-code i-code b-name i-name i-name i-name i-name i-name i-name i-name
请帮我调频106.1长沙音乐广播电台	radio@launch	o o o o o b-code i-code i-code i-code i-code b-name i-name i-name i-name i-name i-name i-name i-name
请帮我调频97.5湖南人民广播电台文艺台	radio@launch	o o o o o b-code i-code i-code i-code b-name i-name i-name i-name i-name i-name i-name i-name i-name i-name i-name
麻烦您可不可以帮我调频99.3嘉善人民广播电台	radio@launch	o o o o o o o o o o o b-code i-code i-code i-code b-name i-name i-name i-name i-name i-name i-name i-name
麻烦您能否帮我调频97.1汉中音乐广播电台	radio@launch	o o o o o o o o o b-code i-code i-code i-code b-name i-name i-name i-name i-name i-name i-name i-name
帮我调频92.4中国国际广播电台行不行？	radio@launch	o o o o b-code i-code i-code i-code b-name i-name i-name i-name i-name i-name i-name i-name o o o o
请帮我调一下电台到镇江新闻广播	radio@launch	o o o o o o o o o b-name i-name i-name i-name i-name i-name
麻烦您可不可以帮我调频98.5扬州人民广播电台新闻台	radio@launch	o o o o o o o o o o o b-code i-code i-code i-code b-name i-name i-name i-name i-name i-name i-name i-name i-name i-name i-name
能不能帮我接听中广流行网	radio@launch	o o o o o o o b-name i-name i-name i-name i-name
请帮我调频105.8南京人民广播电台音乐台	radio@launch	o o o o o b-code i-code i-code i-code i-code b-name i-name i-name i-name i-name i-name i-name i-name i-name i-name i-name
那来个灯谜吧！	riddle@query	o o o b-category i-category o o
打一个灯谜啊，你。	riddle@query	o o o b-category i-category o o o o
打一个谜语男人的腿残。	riddle@query	o o o b-category i-category o o o o o o
也来个灯谜吗？	riddle@query	o o o b-category i-category o o
让我猜个谜语。	riddle@query	o o o o b-category i-category o
讲一个谜语和答案。	riddle@query	o o o b-category i-category o o o o
来个字谜我猜一下。	riddle@query	o o b-category i-category o o o o o
来一个字谜，二。	riddle@query	o o o b-category i-category o o o
我要猜字谜不笨有答案。	riddle@query	o o o b-category i-category o o o o o o
我要猜一个字谜。	riddle@query	o o o o o b-category i-category o
给我讲一个谜语吧！	riddle@query	o o o o o b-category i-category o o
来个字谜吗？	riddle@query	o o b-category i-category o o
讲一个谜语，啊，你，哦。	riddle@query	o o o b-category i-category o o o o o o o
打个谜语吧！	riddle@query	o o b-category i-category o o
讲个谜语猜一下。	riddle@query	o o b-category i-category o o o o
来个灯谜吧！	riddle@query	o o b-category i-category o o
不是我是说我给你猜个谜语吧！	riddle@query	o o o o o o o o o o b-category i-category o o
来一个灯谜，你。	riddle@query	o o o b-category i-category o o o
你给我说几个谜语。	riddle@query	o o o o o o b-category i-category o
搞笑谜语。	riddle@query	b-category i-category i-category i-category o
查询大力传媒的股票	stock@query	o o b-name i-name i-name i-name o o o
平安保险的股票价格	stock@query	b-name i-name i-name i-name o o o o o
永辉超市股份的价格	stock@query	b-name i-name i-name i-name o o o o o
看一下中式传媒股票的涨跌幅	stock@riserate_query	o o o b-name i-name i-name i-name o o o o o o
科大讯飞昨日成交价	stock@query	b-name i-name i-name i-name b-yesterday i-yesterday o o o
查询一下讯飞科大今天的股票	stock@query	o o o o b-name i-name i-name i-name o o o o o
中国银行是跌了还是涨了	stock@riserate_query	b-name i-name i-name i-name o o o o o o o
腾讯公司的股票	stock@query	b-name i-name o o o o o
查询三一重工股票	stock@query	o o b-name i-name i-name i-name o o
中国石化的股票是涨还是跌	stock@riserate_query	b-name i-name i-name i-name o o o o o o o o
上海能源这支股票怎么样	stock@query	b-name i-name i-name i-name o o o o o o o
江苏阳光的股票怎么样了	stock@query	b-name i-name i-name i-name o o o o o o o
居然股份股票怎么样	stock@query	b-name i-name i-name i-name o o o o o
搜索中国移动股票	stock@query	o o b-name i-name i-name i-name o o
查询东吴证券的股票	stock@query	o o b-name i-name i-name i-name o o o
陈娴tcl股票是涨还是跌了	stock@riserate_query	o o b-name i-name i-name o o o o o o o o
查询海螺水泥的股票	stock@query	o o b-name i-name i-name i-name o o o
中国银行股票怎么样	stock@query	b-name i-name i-name i-name o o o o o
中国太保股票	stock@query	b-name i-name i-name i-name o o
查询洛阳钼业的股票	stock@query	o o b-name i-name i-name i-name o o o
查询科大讯飞的股价	stock@query	o o b-name i-name i-name i-name o o o
查下李宁公司的股票	stock@query	o o b-name i-name o o o o o
伊利股份	stock@query	b-name i-name i-name i-name
腾讯股票昨日收盘价	stock@closeprice_query	b-name i-name o o b-yesterday i-yesterday o o o
上海宝钢股票	stock@query	o o b-name i-name o o
中国工商银行的股票	stock@query	b-name i-name i-name i-name i-name i-name o o o
我想看一下科大讯飞的股票	stock@query	o o o o o b-name i-name i-name i-name o o o
通宝能源股票	stock@query	b-name i-name i-name i-name o o
查寻上海能源的股票	stock@query	o o b-name i-name i-name i-name o o o
宏达高科的股票跌了没有	stock@riserate_query	b-name i-name i-name i-name o o o o o o o
查一查同方股份的股票	stock@query	o o o b-name i-name i-name i-name o o o
搜索蒙牛的股市行情	stock@query	o o b-name i-name o o o o o
青岛海信股票	stock@query	o o b-name i-name o o
富瑞特装股票	stock@query	b-name i-name i-name i-name o o
查询濮耐股份的股票	stock@query	o o b-name i-name i-name i-name o o o
包钢稀土股票价格	stock@query	b-name i-name i-name i-name o o o o
查询一汽轿车股票	stock@query	o o b-name i-name i-name i-name o o
查下银星能源股票	stock@query	o o b-name i-name i-name i-name o o
中信证券股票	stock@query	b-name i-name i-name i-name o o
搜索泰亚股份股票	stock@query	o o b-name i-name i-name i-name o o
搜索中国移动的股市行情	stock@query	o o b-name i-name i-name i-name o o o o o
讯飞科技股票价格	stock@query	b-name i-name i-name i-name o o o o
永高股份的股票	stock@query	b-name i-name i-name i-name o o o
中水渔业的股票	stock@query	b-name i-name i-name i-name o o o
安徽合力股票	stock@query	b-name i-name i-name i-name o o
截止目前银鸽投资股份的市值是多少	stock@query	o o o o b-name i-name i-name i-name o o o o o o o o
科大讯飞今天的股票	stock@query	b-name i-name i-name i-name o o o o o
人福医药股票	stock@query	b-name i-name i-name i-name o o
杰瑞股份股价	stock@query	b-name i-name i-name i-name o o
美菱电器的昨日收盘价是多少	stock@closeprice_query	b-name i-name i-name i-name o b-yesterday i-yesterday o o o o o o
查寻科大讯飞的股	stock@query	o o b-name i-name i-name i-name o o
查寻天龙集团的股票	stock@query	o o b-name i-name i-name i-name o o o
拨打张月华的电话	telephone@dial	o o b-name i-name i-name o o o
给小鱼打电话	telephone@dial	o b-name i-name o o o
呼叫鹏鹏	telephone@dial	o o b-name i-name
我想打电话给李四	telephone@dial	o o o o o o b-name i-name
打电话给之山	telephone@dial	o o o o b-name i-name
呼叫广岁	telephone@dial	o o b-name i-name
打电话给艾背	telephone@dial	o o o o b-name i-name
打电话给小女儿	telephone@dial	o o o o b-name i-name i-name
打电话给my god	telephone@dial	o o o o b-name i-name i-name i-name i-name i-name
帮我打电话给港铁轮	telephone@dial	o o o o o o b-name i-name i-name
打电话给奥巴马	telephone@dial	o o o o b-name i-name i-name
打一下公司张总的电话	telephone@dial	o o o b-category i-category b-name i-name o o o
呼叫徐媛	telephone@dial	o o b-name i-name
拨号曹兴发	telephone@dial	o o b-name i-name i-name
打电话给魏文强	telephone@dial	o o o o b-name i-name i-name
打电话给陈雷	telephone@dial	o o o o b-name i-name
给吴方婷打电话	telephone@dial	o b-name i-name i-name o o o
打电话给美华	telephone@dial	o o o o b-name i-name
给万结打电话	telephone@dial	o b-name i-name o o o
打电话给潘立长	telephone@dial	o o o o b-name i-name i-name
给金华打电话	telephone@dial	o b-name i-name o o o
拨打陈艾电话	telephone@dial	o o b-name i-name o o
打电话给李新颖	telephone@dial	o o o o b-name i-name i-name
呼叫a 二小姐	telephone@dial	o o o o b-name i-name i-name
打石宝电话	telephone@dial	o b-name i-name o o
给木九超打电话	telephone@dial	o b-name i-name i-name o o o
打电话给王宇婕	telephone@dial	o o o o b-name i-name i-name
打电话给张志国	telephone@dial	o o o o b-name i-name i-name
打电话给大培	telephone@dial	o o o o b-name i-name
你给朴叔打电话	telephone@dial	o o b-name i-name o o o
打电话给卢静	telephone@dial	o o o o b-name i-name
从合肥到北京的列车	train@query	o b-startloc_city i-startloc_city o b-endloc_city i-endloc_city o o o
查一下到洛阳的高铁	train@query	o o o o b-endloc_city i-endloc_city o b-category i-category
查询柳州到昆明的列车	train@query	o o b-startloc_city i-startloc_city o b-endloc_city i-endloc_city o o o
贵阳至长沙的火车票	train@query	b-startloc_city i-startloc_city o b-endloc_city i-endloc_city o o o o
合肥到芜湖的火车票	train@query	b-startloc_city i-startloc_city o b-endloc_city i-endloc_city o o o o
厦门到福建建阳的火车是几点呢	train@query	b-startloc_city i-startloc_city o b-endloc_province i-endloc_province i-endloc_area o o o o o o o o
深圳至合肥的火车票	train@query	b-startloc_city i-startloc_city o b-endloc_city i-endloc_city o o o o
查一下潍坊到威海的火车票	train@query	o o o b-startloc_city i-startloc_city o b-endloc_city i-endloc_city o o o o
广州到南宁的火车	train@query	b-startloc_city i-startloc_city o b-endloc_city i-endloc_city o o o
湖北荆州到黄石的火车	train@query	b-startloc_province i-startloc_province b-startloc_city i-startloc_city o b-endloc_city i-endloc_city o o o
明天到郑州的火车	train@query	b-startdate_date i-startdate_date o b-endloc_city i-endloc_city o o o
查一下南昌到南京的火车	train@query	o o o b-startloc_city i-startloc_city o o o o o o
从合肥去西安的火车	train@query	o b-startloc_city i-startloc_city o b-endloc_city i-endloc_city o o o
请查询丰城到南昌的火车列车列车时刻表	train@query	o o o b-startloc_area i-startloc_area o b-endloc_city i-endloc_city o o o o o o o o o o
明天广州到北京的火车	train@query	b-startdate_date i-startdate_date b-startloc_city i-startloc_city o b-endloc_city i-endloc_city o o o
去广州的火车票	train@query	o b-endloc_city i-endloc_city o o o o
帮我查询一下温州到上海的火车	train@query	o o o o o o b-startloc_city i-startloc_city o b-endloc_city i-endloc_city o o o
杭州南站到龙游的火车有哪几班	train@query	b-startloc_poi i-startloc_poi i-startloc_poi i-startloc_poi o b-endloc_area i-endloc_area o o o o o o o
北京到镇江的火车	train@query	b-startloc_city i-startloc_city o b-endloc_city i-endloc_city o o o
查一下那个南京到昆明的火车	train@query	o o o o o b-startloc_city i-startloc_city o b-endloc_city i-endloc_city o o o
查一下苏州到洛阳的火车票	train@query	o o o b-startloc_city i-startloc_city o b-endloc_city i-endloc_city o o o o
南京到厦门的火车票	train@query	b-startloc_city i-startloc_city o b-endloc_city i-endloc_city o o o o
明天到合肥的火车	train@query	b-startdate_date i-startdate_date o b-endloc_city i-endloc_city o o o
查询安阳到郑州的动车	train@query	o o b-startloc_city i-startloc_city o b-endloc_city i-endloc_city o b-category i-category
查看滁州到南京的火车票	train@query	o o b-startloc_city i-startloc_city o b-endloc_city i-endloc_city o o o o
明天有火车到襄阳吗	train@query	b-startdate_date i-startdate_date o o o o b-endloc_city i-endloc_city o
枣庄到淄博的火车票	train@query	b-startloc_city i-startloc_city o b-endloc_city i-endloc_city o o o o
明天南京到徐州的火车	train@query	b-startdate_date i-startdate_date b-startloc_city i-startloc_city o b-endloc_city i-endloc_city o o o
温州到瑞昌的火车	train@query	b-startloc_city i-startloc_city o b-endloc_area i-endloc_area o o o
查一下济南到潍坊昌乐的火车	train@query	o o o b-startloc_city i-startloc_city o b-endloc_city i-endloc_city b-endloc_area i-endloc_area o o o
厦门到赣州的火车票	train@query	b-startloc_city i-startloc_city o b-endloc_city i-endloc_city o o o o
查查一下连江到湛江的火车票	train@query	o o o o b-startloc_area i-startloc_area o b-endloc_city i-endloc_city o o o o
到北京的火车班次	train@query	o b-endloc_city i-endloc_city o o o o o
查下温州到杭州的火车票	train@query	o o b-startloc_city i-startloc_city o b-endloc_city i-endloc_city o o o o
帮我在百度里搜一下东莞到北京的火车	train@query	o o o o o o o o o b-startloc_city i-startloc_city o b-endloc_city i-endloc_city o o o
帮我查一下赣州到南昌的火车票	train@query	o o o o o b-startloc_city i-startloc_city o b-endloc_city i-endloc_city o o o o
查一下合肥到淮南明天的火车	train@query	o o o b-startloc_city i-startloc_city o b-endloc_city i-endloc_city b-startdate_date i-startdate_date o o o
宿州到北京的火车有哪些	train@query	b-startloc_city i-startloc_city o b-endloc_city i-endloc_city o o o o o o
帮我查一下广州到深圳的火车	train@query	o o o o o b-startloc_city i-startloc_city o b-endloc_city i-endloc_city o o o
广州去昆明的火车	train@query	b-startloc_city i-startloc_city o b-endloc_city i-endloc_city o o o
明天去蚌埠的车票	train@query	b-startdate_date i-startdate_date o b-endloc_city i-endloc_city o o o
去枣庄的火车	train@query	o b-endloc_city i-endloc_city o o o
查询宜春到南昌的火车列车时刻表	train@query	o o b-startloc_city i-startloc_city o b-endloc_city i-endloc_city o o o o o o o o
四月六号南宁到上海的火车	train@query	b-startdate_date i-startdate_date i-startdate_date i-startdate_date b-startloc_city i-startloc_city o b-endloc_city i-endloc_city o o o
深圳到开封的火车	train@query	b-startloc_city i-startloc_city o b-endloc_city i-endloc_city o o o
明天有没有洛阳到西安的高铁	train@query	b-startdate_date i-startdate_date o o o b-startloc_city i-startloc_city o b-endloc_city i-endloc_city o b-category i-category
查询泉州到上海的动车票	train@query	o o b-startloc_city i-startloc_city o b-endloc_city i-endloc_city o b-category i-category o
帮我查一下苏州到上海的火车	train@query	o o o o o b-startloc_city i-startloc_city o b-endloc_city i-endloc_city o o o
广州到孝感的火车	train@query	b-startloc_city i-startloc_city o b-endloc_city i-endloc_city o o o
帮我查一下赣州到杭州的火车票	train@query	o o o o o b-startloc_city i-startloc_city o b-endloc_city i-endloc_city o o o o
很高兴认识你英语怎么说啊	translation@translation	b-content i-content i-content i-content i-content i-content b-target i-target o o o o
中国制用英文怎么说	translation@translation	b-content i-content i-content o b-target i-target o o o
翻译李淼	translation@translation	o o b-content i-content
香蕉的英语怎么说	translation@translation	b-content i-content o b-target i-target o o o
今天是个好日子的英文怎么讲	translation@translation	b-content i-content i-content i-content i-content i-content i-content o b-target i-target o o o
五用英语怎么说	translation@translation	b-content o b-target i-target o o o
智能手机英语怎么说	translation@translation	b-content i-content i-content i-content b-target i-target o o o
福尔摩探案急翻译成英文	translation@translation	b-content i-content i-content i-content i-content i-content o o o b-target i-target
你怎么了英文怎么讲	translation@translation	b-content i-content i-content i-content b-target i-target o o o
帮我翻译一下我饿了	translation@translation	o b-content i-content i-content o o o o o
翻译共产党员	translation@translation	o o b-content i-content i-content i-content
我去飞机场英语怎么说	translation@translation	b-content i-content i-content i-content i-content b-target i-target o o o
我不知道的英文怎么说	translation@translation	b-content i-content i-content i-content o b-target i-target o o o
我正在睡觉用英语怎么说	translation@translation	b-content i-content i-content i-content i-content o b-target i-target o o o
你去哪用英文怎么说	translation@translation	b-content i-content i-content o b-target i-target o o o
晚安的英语	translation@translation	b-content i-content o b-target i-target
翻译慷慨激昂	translation@translation	o o b-content i-content i-content i-content
我来自美国是一个地地道道的美国人用英语怎么说	translation@translation	b-content i-content i-content i-content i-content i-content i-content i-content i-content i-content i-content i-content i-content i-content i-content i-content o b-target i-target o o o
请翻译苹果	translation@translation	o o o b-content i-content
一加一用英语怎么说	translation@translation	b-content i-content i-content o b-target i-target o o o
我今天帮爷爷洗衣服的英文怎么说	translation@translation	b-content i-content i-content i-content i-content i-content i-content i-content i-content o b-target i-target o o o
中国共产主义的英文怎么说	translation@translation	b-content i-content i-content i-content i-content i-content o b-target i-target o o o
出租车的英文怎么说	translation@translation	b-content i-content i-content o b-target i-target o o o
我今天去北京了英语怎么说	translation@translation	b-content i-content i-content i-content i-content i-content i-content b-target i-target o o o
时间的英文怎么讲	translation@translation	b-content i-content o b-target i-target o o o
香蕉用英语怎么讲	translation@translation	b-content i-content o b-target i-target o o o
腿英文怎么说	translation@translation	b-content b-target i-target o o o
我饿用英文怎么说	translation@translation	b-content i-content o b-target i-target o o o
我喜欢亚楠用英语怎么说	translation@translation	b-content i-content i-content i-content i-content o b-target i-target o o o
我要和妹妹睡觉英语怎么说	translation@translation	b-content i-content i-content i-content i-content i-content i-content b-target i-target o o o
一千五英语怎么说	translation@translation	b-content i-content i-content b-target i-target o o o
你好丑用英文怎么说	translation@translation	b-content i-content i-content o b-target i-target o o o
当前不再呼叫英语怎么说	translation@translation	b-content i-content i-content i-content i-content i-content b-target i-target o o o
大家今天心情如何用英语怎么说	translation@translation	b-content i-content i-content i-content i-content i-content i-content i-content o b-target i-target o o o
你今天去了哪里用英文怎么讲	translation@translation	b-content i-content i-content i-content i-content i-content i-content o b-target i-target o o o
西红柿用英语怎么说	translation@translation	b-content i-content i-content o b-target i-target o o o
我想打你英语怎么说	translation@translation	b-content i-content i-content i-content b-target i-target o o o
桔子英文怎么说	translation@translation	b-content i-content b-target i-target o o o
睡觉用英文怎么说	translation@translation	b-content i-content o b-target i-target o o o
你叫什么名字英文怎么说	translation@translation	b-content i-content i-content i-content i-content i-content b-target i-target o o o
我不明白用英文怎么讲	translation@translation	b-content i-content i-content i-content o b-target i-target o o o
我不吃英文怎么讲	translation@translation	b-content i-content i-content b-target i-target o o o
很高兴见到你英文怎么讲	translation@translation	b-content i-content i-content i-content i-content i-content b-target i-target o o o
北京财经	tvchannel@play	b-name i-name i-name i-name
中央十一台	tvchannel@play	b-name i-name i-name i-name i-name
我想看高尔夫网球频道	tvchannel@play	o o o b-name i-name i-name i-name i-name i-name i-name
打开珠江台	tvchannel@play	o o b-name i-name i-name
宁波一台	tvchannel@play	b-name i-name i-name i-name
先锋乒羽	tvchannel@play	b-name i-name i-name i-name
高清江苏	tvchannel@play	b-resolution i-resolution b-name i-name
东方台	tvchannel@play	b-name i-name i-name
cctv8高清电视剧	epg@query	b-tvchannel i-tvchannel i-tvchannel i-tvchannel i-tvchannel i-tvchannel i-tvchannel b-category i-category i-category
甘肃台	tvchannel@play	b-name i-name i-name
中央电视台电影频道	tvchannel@play	b-name i-name i-name i-name i-name i-name i-name i-name i-name
高清央视综艺	tvchannel@play	b-resolution i-resolution b-name i-name i-name i-name
btvkaku少儿	tvchannel@play	b-name i-name i-name i-name i-name i-name i-name i-name i-name
打开江苏卫视	tvchannel@play	o o b-name i-name i-name i-name
找湖南卫视	tvchannel@play	o b-name i-name i-name i-name
老故事	story@query	b-category i-category i-category
高淳转播2	tvchannel@play	b-name i-name i-name i-name i-name
我要看下中央六套	tvchannel@play	o o o o b-name i-name i-name i-name
cctv7军事农业	tvchannel@play	b-name i-name i-name i-name i-name i-name i-name i-name i-name
远教四台	tvchannel@play	b-name i-name i-name i-name
安徽综艺	tvchannel@play	b-name i-name i-name i-name
我看呀中央五台	tvchannel@play	o o o b-name i-name i-name i-name
游戏竞技频道	tvchannel@play	b-name i-name i-name i-name i-name i-name
我要看湖南台	tvchannel@play	o o o b-name i-name i-name
女性时尚	tvchannel@play	b-name i-name i-name i-name
cctv6电影高清	tvchannel@play	b-name i-name i-name i-name i-name i-name i-name b-resolution i-resolution
高尔夫网球	tvchannel@play	b-name i-name i-name i-name i-name
北京财经台	tvchannel@play	b-name i-name i-name i-name i-name
中央台五套	tvchannel@play	b-name i-name i-name i-name i-name
西藏卫视	tvchannel@play	b-name i-name i-name i-name
哦我想看中央一台	tvchannel@play	o o o o b-name i-name i-name i-name
浙江电视台	tvchannel@play	b-name i-name i-name i-name i-name
听江苏交通广播网	radio@launch	o b-name i-name i-name i-name i-name i-name o
江苏影视	tvchannel@play	b-name i-name i-name i-name
cctv少儿	tvchannel@play	b-name i-name i-name i-name i-name i-name
湖北电视台高清	tvchannel@play	b-name i-name i-name i-name i-name b-resolution i-resolution
央3	tvchannel@play	b-name i-name
中央八	tvchannel@play	b-name i-name i-name
帮我切换到湖南卫视	tvchannel@play	o o o o o b-name i-name i-name i-name
陕西二套	tvchannel@play	b-name i-name i-name i-name
我要看中央五台	tvchannel@play	o o o b-name i-name i-name i-name
axn	tvchannel@play	b-name i-name i-name
调到新疆综艺	tvchannel@play	o o b-name i-name i-name i-name
吉林电视台	tvchannel@play	b-name i-name i-name i-name i-name
在线观看中央七套	tvchannel@play	o o o o b-name i-name i-name i-name
中国教育电视台三台	tvchannel@play	b-name i-name i-name i-name i-name i-name i-name i-name i-name
换江苏卫视	tvchannel@play	o b-name i-name i-name i-name
浙江台	tvchannel@play	b-name i-name i-name
金瓶梅	video@query	b-name i-name i-name
帮我找一找龙门飞甲	video@query	o o o o o b-name i-name i-name i-name
看中国好声音	video@query	o b-name i-name i-name i-name i-name
智慧树	video@query	b-name i-name i-name
开心大冒险	video@query	b-name i-name i-name i-name i-name
看空霸	video@query	o b-name i-name
蓝精灵电影	video@query	b-name i-name i-name b-category i-category
情债	novel@query	b-name i-name
苍狼	video@query	b-name i-name
大头儿子小头爸爸	video@query	b-name i-name i-name i-name i-name i-name i-name i-name
最美的时光	video@query	b-name i-name i-name i-name i-name
爱在何方第三期	video@query	b-name i-name i-name i-name b-episode i-episode i-episode
那么最近有什么好电影呢？	video@query	o o b-timedescr i-timedescr o o o b-scoredescr b-category i-category o o
来点张艺谋出演的节目	video@query	o o b-artist i-artist i-artist b-artistrole i-artistrole o b-category i-category
我想看搞定岳父大人电影	video@query	o o o b-name i-name i-name i-name i-name i-name b-category i-category
电影中国合伙人	video@query	b-category i-category b-name i-name i-name i-name i-name
花开半夏	video@query	b-name i-name i-name i-name
查找电影	video@query	o o b-category i-category
知青	video@query	b-name i-name
给我找最新的盗梦空间	video@query	o o o b-timedescr i-timedescr o b-name i-name i-name i-name
好无聊哇有什么好看的电影	video@query	b-scoredescr i-scoredescr o o o o o o o o b-category i-category
女人的颜色六十九集	video@query	b-name i-name i-name i-name i-name b-episode i-episode i-episode i-episode
歧路兄弟	video@query	b-name i-name i-name i-name
想唱就唱	video@query	b-name i-name i-name i-name
查找桑拿	video@query	o o b-name i-name
搜索最近的，科幻电影。	video@query	o o b-timedescr i-timedescr o o b-tag i-tag b-category i-category o
爱在旅途	video@query	b-name i-name i-name i-name
狄仁杰之通天帝国视频	video@query	b-name i-name i-name i-name i-name i-name i-name i-name o o
打开节目搜索	video@query	o o b-category i-category o o
请帮我放一下剩女保镖	video@query	o o o o o o b-name i-name i-name i-name
美国恐怖电影	video@query	b-area i-area b-tag i-tag b-category i-category
最近有什么好看的电视连续剧武打的。	video@query	b-timedescr i-timedescr o o o b-scoredescr i-scoredescr o b-category i-category i-category i-category i-category b-tag i-tag o o
我想看大武当电影	video@query	o o o b-name i-name i-name b-category i-category
小兵张嘎电影儿	video@query	b-name i-name i-name i-name b-category i-category o
打开新闻	news@play	o o o o
要看名侦探柯南	video@query	o o b-name i-name i-name i-name i-name
播七龙珠	video@query	o b-name i-name i-name
满秋	video@query	b-name i-name
请帮我查找一下奥特曼大电影	video@query	o o o o o o o b-name i-name i-name i-name i-name i-name
动画片巴啦啦小魔仙	video@query	b-tag i-tag b-category b-name i-name i-name i-name i-name i-name
好看足球比赛	video@query	b-scoredescr i-scoredescr b-tag i-tag i-tag i-tag
查最近的电影。	cinemas@query	o o o o o o o
北疆战士	video@query	b-name i-name i-name i-name
当婆婆遇上妈	video@query	b-name i-name i-name i-name i-name i-name
高清动作电影	video@query	b-resolution i-resolution b-tag i-tag b-category i-category
我想看周星驰的喜剧电影喜剧之王	video@query	o o o b-artist i-artist i-artist o b-tag i-tag i-name i-name o o o o
魔幻手机	video@query	b-name i-name i-name i-name
幻影忍者	video@query	b-name i-name i-name i-name
古惑仔	video@query	b-name i-name i-name
电影私人定制	video@query	b-category i-category b-name i-name i-name i-name
我想要看很火的电影	video@query	o o o o o b-popularity o b-category i-category
风车第十五集	video@query	b-name i-name b-episode i-episode i-episode i-episode
杨三姐告状	video@query	b-name i-name i-name i-name i-name
情景剧电视剧	video@query	b-tag i-tag o b-category i-category i-category
搜索国外大片	video@query	o o b-area i-area b-category i-category
赛罗奥特曼	video@query	b-name i-name i-name i-name i-name
看看最近有什么电影？	cinemas@query	o o o o o o o o o o
查一下最近有什么电影？	cinemas@query	o o o o o o o o o o o
看上周五的爸爸我去哪儿	video@query	o b-datetime_date i-datetime_date i-datetime_date o b-name i-name i-name i-name i-name i-name
我的爱金枝玉叶	video@query	b-name i-name i-name i-name i-name i-name i-name
有什么新电影	cinemas@query	o o o o o o
妈妈的花样年华	video@query	b-name i-name i-name i-name i-name i-name i-name
我要看李连杰的电影	video@query	o o o b-artist i-artist i-artist o b-category i-category
有没有张艺谋导演的热门电影	video@query	o o o b-artist i-artist i-artist b-artistrole i-artistrole o b-popularity i-popularity b-category i-category
老版红楼梦	video@query	o o b-name i-name i-name
一个鬼子都不留	video@query	b-name i-name i-name i-name i-name i-name i-name
最近有什么好看得	video@query	b-timedescr i-timedescr o o o b-scoredescr i-scoredescr o
胜者即是正义	video@query	b-name i-name i-name i-name i-name i-name
文娱播报	video@query	b-name i-name i-name i-name
找一下詹姆斯卡梅隆拍的电影	video@query	o o o b-artist i-artist i-artist i-artist i-artist i-artist o o b-category i-category
搜索电影晚秋	video@query	o o b-category i-category b-name i-name
江山	video@query	b-name i-name
独立纵队电视剧	video@query	b-name i-name i-name i-name b-category i-category i-category
胜女的代价电视剧	video@query	b-name i-name i-name i-name i-name b-category i-category i-category
查询神鬼认证	video@query	o o b-name i-name i-name i-name
李瑞英主持的最新的新闻节目	video@query	b-artist i-artist i-artist b-artistrole i-artistrole o b-timedescr i-timedescr i-tag o o b-category i-category
换到米老鼠	video@query	o o b-name i-name i-name
半夜不要照镜子	video@query	b-name i-name i-name i-name i-name i-name i-name
铁甲钢拳	video@query	b-name i-name i-name i-name
读心专家	video@query	b-name i-name i-name i-name
电视剧火凤凰	video@query	b-category i-category i-category b-name i-name i-name
有你才幸福	video@query	b-name i-name i-name i-name i-name
推理动漫	video@query	b-tag i-tag b-category i-category
我想看珍珠港	video@query	o o o b-name i-name i-name
2013年的警匪电视剧	video@query	b-datetime_date i-datetime_date i-datetime_date i-datetime_date i-datetime_date o b-tag i-tag b-category i-category i-category
播放特种兵之利刃出鞘	video@query	o o b-name i-name i-name i-name i-name i-name i-name i-name
我想看变形金刚哦	video@query	o o o b-name i-name i-name i-name o
地心历险记二	video@query	b-name i-name i-name i-name i-name i-name
美国热门的恐怖电影	video@query	b-area i-area b-popularity i-popularity o b-tag i-tag b-category i-category
青春期撞上更年期二	video@query	b-name i-name i-name i-name i-name i-name i-name i-name i-name
武间道	video@query	b-name i-name i-name
看动物卡通	video@query	o b-tag i-tag i-tag i-tag
康熙大帝	video@query	b-name i-name i-name i-name
2013年陈可辛导演的好看的电影	video@query	b-datetime_date i-datetime_date i-datetime_date i-datetime_date i-datetime_date b-artist i-artist i-artist b-artistrole i-artistrole o b-scoredescr i-scoredescr o b-category i-category
刑侦电视剧	video@query	b-tag i-tag b-category i-category i-category
薛平贵与王宝钏	video@query	b-name i-name i-name i-name i-name i-name i-name
福尔摩斯	video@query	b-name i-name i-name i-name
英雄本色电影	video@query	b-name i-name i-name i-name b-category i-category
太阳第九集	video@query	b-name i-name b-episode i-episode i-episode
生活大爆炸	video@query	b-name i-name i-name i-name i-name
猫眼三姐妹	video@query	b-name i-name i-name i-name i-name
我是说我要看一起又看流星雨	video@query	o o o o o o b-name i-name i-name i-name i-name i-name i-name
搜索逃学威龙第二部	video@query	o o b-name i-name i-name i-name b-season i-season i-season
我是特种兵二	video@query	b-name i-name i-name i-name i-name i-name
中国合伙人	video@query	b-name i-name i-name i-name i-name
智取威虎山	video@query	b-name i-name i-name i-name i-name
韩国电视连续剧老大	video@query	b-area i-area b-category i-category i-category i-category i-category b-name i-name
甄嬛传高清	video@query	b-name i-name i-name b-resolution i-resolution
陈真	video@query	b-name i-name
热血动漫	video@query	b-tag i-tag b-category i-category
中国新声代	video@query	b-name i-name i-name i-name i-name
我的幸福	video@query	b-name i-name i-name i-name
查找90年代好评的武侠电影	video@query	o o b-decade i-decade i-decade i-decade b-payment i-payment o b-tag i-tag b-category i-category
看千金归来第五集	video@query	o b-name i-name i-name i-name b-episode i-episode i-episode
美好的时代	video@query	b-name i-name i-name i-name i-name
最近有什么科幻电影？	cinemas@query	o o o o o b-category i-category o o o
铁甲威虫	video@query	b-name i-name i-name i-name
最近有什么影片？	cinemas@query	o o o o o o o o
心术电影	video@query	b-name i-name b-category i-category
海棉宝宝	video@query	b-name i-name i-name i-name
请打开电影	video@query	o o o b-category i-category
最近有什么好电影吗？	cinemas@query	o o o o o o o o o o
看电影啊	video@query	o b-category i-category o
中国最强音	video@query	b-name i-name i-name i-name i-name
那会不会下雨	weather@query	o b-questionword i-questionword i-questionword o b-subfocus
你好请问一下明天广州的天气如何	weather@query	o o o o o o b-datetime_date i-datetime_date b-location_city i-location_city o o o o o
合肥明天的湿度如何	weather@query	b-location_city i-location_city b-datetime_date i-datetime_date o b-subfocus i-subfocus o o
摩尔勇士	website@open	b-name i-name i-name i-name
把我打开淘宝的网页	website@open	o o o o b-name i-name o o o
赶集网	website@open	b-name i-name i-name
四川新闻网	website@open	b-name i-name i-name i-name i-name
苏宁易购	website@open	b-name i-name i-name i-name
把淘宝网打开	website@open	o b-name i-name i-name o o
看网易财经	website@open	o b-name i-name i-name i-name
打开河南英东网站	website@open	o o b-name i-name i-name i-name o o
激动	website@open	b-name i-name
新蛋网	website@open	b-name i-name i-name
中华军事网	website@open	b-name i-name i-name i-name i-name
打开苹果香港官方网站	website@open	o o b-name i-name i-name i-name i-name i-name i-name i-name
索尼爱立信官网	website@open	b-name i-name i-name i-name i-name o o
打开三星首页	website@open	o o b-name i-name o o
打开4399小游戏	website@open	o o b-name i-name i-name i-name i-name i-name i-name
打开宽带商务网站	website@open	o o b-name i-name i-name i-name i-name i-name
现在我也想上新浪网了	website@open	o o o o o o b-name i-name i-name o
浏览一下百度	website@open	o o o o b-name i-name
中国新华网打开	website@open	o o b-name i-name i-name o o
打开科大讯飞网站	website@open	o o b-name i-name i-name i-name o o
开启雅虎	website@open	o o b-name i-name
打开杜鑫文的网站	website@open	o o b-name i-name i-name i-name i-name i-name
进你的官网	website@open	o b-name i-name i-name i-name
打开丰顺县政府网	website@open	o o b-name i-name i-name i-name i-name i-name
进入三w点百度点com	website@open	o o b-name i-name i-name i-name i-name i-name i-name i-name i-name
打开网页小米论坛	website@open	o o o o b-name i-name i-name i-name
上百度网站	website@open	o b-name i-name o o
幻剑书盟	website@open	b-name i-name i-name i-name
聚友网	website@open	b-name i-name i-name
广西新闻网	website@open	b-name i-name i-name i-name i-name
我要打开百度	website@open	o o o o b-name i-name
新浪汽车	website@open	b-name i-name i-name i-name
九阴真经	video@query	b-name i-name i-name i-name
我想上网易	website@open	o o o b-name i-name
你帮我打开网站	website@open	o o o o o o o
打开搜狐网首页	website@open	o o b-name i-name i-name o o
但是我想上腾讯网	website@open	o o o o o b-name i-name i-name
打开互联网啦	website@open	o o o o o o
上美空网	website@open	o b-name i-name i-name
中国新闻网网站	website@open	b-name i-name i-name i-name i-name o o
